dir,pong_x,pong_y,bot_x,quality,win
1,735,592,1016,424,True
1,632,27,515,488,True
0,17,106,699,593,False
0,55,240,607,367,False
-1,549,41,829,788,True
1,201,516,1016,500,False
1,754,610,148,-462,True
0,505,621,353,-268,False
1,427,273,807,534,False
0,337,573,506,-67,False
1,414,997,259,-738,False
0,149,241,878,637,False
0,783,424,651,227,True
-1,658,146,509,363,True
1,1000,506,329,-177,True
1,98,562,545,-17,False
-1,224,276,72,-204,False
0,921,983,806,-177,True
-1,749,291,618,327,True
-1,453,318,770,452,False
0,505,831,961,130,False
0,424,100,439,339,False
-1,268,910,861,-49,False
0,359,543,872,329,False
-1,856,743,816,73,True
1,268,4,362,358,False
-1,22,684,20,-664,False
1,475,228,1092,864,False
-1,387,989,247,-742,False
-1,892,30,178,148,True
-1,428,94,316,222,False
-1,806,319,752,433,True
-1,717,913,762,-151,True
0,903,373,325,-48,True
0,598,326,543,217,True
0,399,822,145,-677,False
1,962,8,1021,1013,True
1,837,325,662,337,True
1,562,82,336,254,False
-1,685,157,-60,-217,True
0,146,947,615,-332,False
-1,553,655,73,-582,True
-1,241,455,-54,-509,False
1,443,415,921,506,False
0,798,330,590,260,True
0,291,989,613,-376,False
-1,251,325,240,-85,False
1,149,718,939,221,False
1,510,319,469,150,False
0,862,770,666,-104,True
0,227,571,340,-231,False
1,83,491,610,119,False
0,267,902,206,-696,False
0,487,933,553,-380,False
-1,513,696,50,-646,True
1,787,842,999,157,True
1,691,343,830,487,True
-1,741,883,72,-811,True
1,690,947,289,-658,True
1,399,327,1013,686,False
1,992,186,173,-13,True
-1,316,170,171,1,False
0,530,74,511,437,False
0,816,601,473,-128,True
1,311,1000,774,-226,False
-1,667,25,301,276,True
-1,227,719,688,-31,False
-1,7,132,283,151,False
0,43,881,935,54,False
1,188,784,647,-137,False
1,314,24,1025,1001,False
1,311,144,151,7,False
-1,777,493,602,109,True
-1,13,564,498,-66,False
0,372,96,22,-74,False
1,882,107,1073,966,True
1,450,414,209,-205,False
0,88,474,954,480,False
0,451,11,933,922,False
0,31,103,843,740,False
0,39,668,741,73,False
1,157,40,843,803,False
1,973,908,945,37,True
0,515,940,722,-218,True
1,341,109,605,496,False
0,220,666,760,94,False
-1,971,659,595,-64,True
-1,404,516,825,309,False
-1,109,921,610,-311,False
0,299,148,373,225,False
-1,633,955,-81,-1036,True
1,599,263,562,299,False
-1,537,301,99,-202,True
-1,236,997,791,-206,False
-1,662,844,833,-11,True
0,182,302,324,22,False
0,401,945,858,-87,False
1,607,639,444,-195,False
1,38,738,1051,313,False
-1,163,485,-31,-516,False
0,280,197,345,148,False
0,394,802,983,181,False
0,54,552,435,-117,False
0,166,52,290,238,False
-1,182,225,110,-115,False
1,721,187,839,652,True
-1,503,968,552,-416,True
1,603,207,688,481,False
-1,130,123,202,79,False
1,335,100,436,336,False
-1,413,855,664,-191,False
1,534,890,192,-698,False
-1,245,88,570,482,False
1,113,550,641,91,False
-1,462,227,321,94,True
1,985,237,1088,851,True
0,430,318,222,-96,False
0,200,963,230,-733,False
-1,261,196,437,241,False
1,505,548,691,143,False
1,107,66,622,556,False
-1,271,184,-70,-254,False
1,84,574,957,383,False
1,879,27,301,274,True
0,665,776,198,-578,True
1,201,365,228,-137,False
-1,840,149,223,74,True
1,805,276,668,392,True
1,444,533,868,335,False
1,361,949,1035,86,False
0,723,484,86,-398,True
0,724,438,215,-223,True
0,690,390,737,347,True
1,110,904,120,-784,False
1,770,447,788,341,True
1,148,417,266,-151,False
0,762,481,853,372,True
-1,481,302,303,1,True
-1,375,883,-28,-911,False
-1,819,246,357,111,True
0,528,12,321,309,False
-1,348,688,22,-666,False
0,859,709,624,-85,True
0,915,959,85,-874,True
-1,789,558,244,-314,True
-1,414,656,290,-366,False
1,950,591,928,337,True
1,966,888,850,-38,True
1,730,90,316,226,True
-1,765,584,361,-223,True
-1,614,296,-88,-384,True
1,125,133,560,427,False
0,195,899,249,-650,False
0,42,299,450,151,False
0,717,827,821,-6,True
1,287,856,1050,194,False
0,64,414,169,-245,False
0,805,133,664,531,True
-1,112,443,637,194,False
0,851,764,691,-73,True
1,361,504,292,-212,False
0,576,160,876,716,True
1,765,549,944,395,True
-1,444,72,524,452,True
-1,884,975,366,-609,True
-1,546,594,270,-324,True
0,646,99,682,583,True
1,725,768,281,-487,True
1,441,962,278,-684,False
1,336,656,757,101,False
1,967,858,625,-233,True
0,172,925,108,-817,False
1,393,191,562,371,False
-1,623,727,13,-714,True
1,237,143,210,67,False
1,970,258,543,285,True
0,876,386,76,-310,True
1,505,441,858,417,False
0,400,491,993,502,False
-1,104,73,-4,-77,False
0,656,505,263,-242,True
-1,525,107,133,26,True
1,111,437,695,258,False
0,995,347,696,349,True
-1,243,916,521,-395,False
1,310,462,558,96,False
1,763,281,566,285,True
-1,270,78,591,513,False
0,437,723,903,180,False
0,775,281,632,351,True
-1,594,112,12,-100,True
-1,407,822,372,-450,False
-1,561,279,769,490,True
-1,990,32,734,702,True
-1,174,184,0,-184,False
0,828,240,326,86,True
1,81,889,982,93,False
-1,826,417,659,242,True
1,870,833,1020,187,True
0,157,403,803,400,False
1,928,646,268,-378,True
0,414,760,727,-33,False
-1,698,741,199,-542,True
0,880,538,49,-489,True
0,597,496,934,438,True
-1,247,959,496,-463,False
0,610,109,27,-82,True
-1,381,658,893,235,False
0,165,207,374,167,False
0,157,74,780,706,False
0,523,48,585,537,False
-1,999,941,454,-487,True
1,535,771,941,170,False
-1,368,118,441,323,False
1,251,844,1014,170,False
1,78,824,601,-223,False
1,557,833,607,-226,False
1,826,666,880,214,True
0,778,246,238,-8,True
0,225,719,994,275,False
0,292,490,733,243,False
0,204,105,152,47,False
1,298,571,741,170,False
-1,728,273,862,589,True
-1,909,944,444,-500,True
0,999,485,615,130,True
0,176,877,612,-265,False
-1,670,400,-82,-482,True
1,129,837,954,117,False
-1,676,218,19,-199,True
1,858,839,315,-524,True
0,378,353,786,433,False
1,267,727,333,-394,False
-1,116,62,95,33,False
0,763,781,585,-196,True
1,335,622,833,211,False
0,447,508,446,-62,False
-1,241,329,-33,-362,False
1,871,832,1087,255,True
-1,622,692,27,-665,True
1,929,818,1048,230,True
-1,4,614,725,111,False
-1,203,226,563,337,False
-1,911,510,443,-67,True
0,579,182,129,-53,False
1,391,610,132,-478,False
-1,220,554,344,-210,False
-1,901,620,494,-126,True
-1,364,48,859,811,False
0,158,414,980,566,False
0,386,402,255,-147,False
0,71,727,583,-144,False
-1,907,123,560,437,True
0,2,335,665,330,False
1,913,539,866,327,True
-1,103,495,512,17,False
1,563,895,616,-279,False
-1,146,897,-54,-951,False
0,115,67,604,537,False
0,954,810,441,-369,True
-1,730,743,164,-579,True
1,718,541,595,54,True
-1,843,265,447,182,True
-1,274,572,55,-517,False
1,725,585,671,86,True
-1,145,346,586,240,False
-1,155,237,784,547,False
-1,213,538,114,-424,False
-1,771,750,385,-365,True
0,363,131,74,-57,False
-1,974,272,882,610,True
-1,197,365,244,-121,False
-1,326,10,741,731,False
-1,371,307,763,456,False
1,987,185,578,393,True
1,207,961,753,-208,False
0,866,480,845,365,True
-1,34,739,102,-637,False
-1,792,288,672,384,True
0,62,942,504,-438,False
0,90,152,379,227,False
-1,517,574,521,-53,True
0,44,702,980,278,False
1,496,409,648,239,False
-1,925,774,19,-755,True
-1,226,418,699,281,False
1,851,510,984,474,True
0,776,860,733,-127,True
1,549,335,492,157,False
-1,274,526,172,-354,False
1,441,334,139,-195,False
1,511,479,348,-131,False
1,62,159,529,370,False
0,646,178,979,801,True
1,129,908,172,-736,False
0,955,457,294,-163,True
-1,834,233,715,482,True
0,801,439,519,80,True
0,391,565,651,86,False
1,826,620,755,135,True
1,372,14,528,514,False
0,286,641,539,-102,False
0,499,887,113,-774,False
0,397,537,742,205,False
1,284,166,846,680,False
0,906,146,755,609,True
0,397,770,571,-199,False
0,292,155,756,601,False
1,762,801,492,-309,True
0,151,602,157,-445,False
0,562,93,867,774,True
0,359,756,174,-582,False
1,937,15,944,929,True
0,663,868,254,-614,True
0,646,407,183,-224,True
0,290,727,631,-96,False
1,733,448,593,145,True
1,383,642,461,-181,False
1,443,15,133,118,False
0,908,563,875,312,True
0,737,193,319,126,True
-1,622,327,697,370,True
-1,922,388,516,128,True
-1,896,632,483,-149,True
-1,647,294,365,71,True
-1,7,932,695,-237,False
-1,457,990,775,-215,False
0,536,653,888,235,True
-1,917,762,792,30,True
-1,389,658,486,-172,False
-1,19,214,644,430,False
1,45,923,541,-382,False
-1,830,257,158,-99,True
0,832,357,34,-323,True
0,14,425,751,326,False
0,110,845,17,-828,False
-1,634,460,-22,-482,True
-1,657,784,145,-639,True
1,913,707,167,-540,True
0,778,373,415,42,True
-1,717,826,693,-133,True
-1,80,656,512,-144,False
0,823,733,171,-562,True
0,196,298,493,195,False
-1,680,126,774,648,True
-1,240,820,554,-266,False
1,375,321,147,-174,False
-1,68,47,578,531,False
0,833,540,526,-14,True
-1,700,781,548,-233,True
0,470,168,378,210,False
1,873,203,872,669,True
0,66,402,570,168,False
0,460,819,108,-711,False
-1,463,774,467,-307,False
1,30,689,391,-298,False
0,776,211,602,391,True
-1,110,305,57,-248,False
1,164,661,981,320,False
-1,699,945,488,-457,True
1,795,229,759,530,True
-1,555,890,780,-110,True
0,481,904,550,-354,False
0,400,473,436,-37,False
0,712,633,873,240,True
-1,693,779,660,-119,True
0,539,734,568,-166,True
-1,121,615,330,-285,False
-1,120,48,126,78,False
-1,584,786,591,-195,True
0,486,201,749,548,False
1,638,216,400,184,True
0,988,110,717,607,True
0,8,439,796,357,False
1,684,727,369,-358,True
1,691,198,509,311,True
1,159,648,758,110,False
-1,196,33,-17,-50,False
1,617,308,285,-23,False
-1,24,861,862,1,False
1,852,921,914,-7,True
1,173,661,464,-197,False
1,825,611,1099,488,True
0,856,941,288,-653,True
1,877,354,902,548,True
-1,305,231,180,-51,False
0,678,416,812,396,True
0,794,533,23,-510,True
1,103,322,461,139,False
0,135,130,672,542,False
0,653,98,557,459,True
1,445,965,277,-688,False
-1,110,549,500,-49,False
-1,482,202,334,132,True
0,126,362,721,359,False
1,222,527,219,-308,False
0,675,327,87,-240,True
1,76,929,365,-564,False
-1,627,772,-35,-807,True
1,840,294,964,670,True
-1,657,602,181,-421,True
-1,234,310,583,273,False
0,691,459,294,-165,True
1,477,966,901,-65,False
-1,338,779,657,-122,False
1,329,806,865,59,False
0,235,286,304,18,False
1,994,575,945,370,True
0,68,148,408,260,False
-1,923,453,487,34,True
-1,336,872,324,-548,False
0,366,86,613,527,False
0,985,303,747,444,True
0,94,80,539,459,False
0,590,770,974,204,True
1,473,909,422,-487,False
1,541,14,770,756,False
1,887,338,304,-34,True
1,16,325,237,-88,False
0,249,596,160,-436,False
0,960,377,683,306,True
0,418,208,133,-75,False
0,755,261,485,224,True
0,346,440,312,-128,False
1,895,928,256,-672,True
1,44,437,785,348,False
0,370,242,692,450,False
0,582,827,938,111,True
0,923,12,926,914,True
0,695,78,477,399,True
0,36,253,656,403,False
-1,77,840,511,-329,False
0,948,846,989,143,True
-1,279,658,-93,-751,False
0,364,828,362,-466,False
1,589,112,422,310,False
0,529,302,413,111,False
1,914,315,1014,699,True
-1,230,757,-87,-844,False
0,373,91,796,705,False
1,966,367,985,618,True
0,234,94,41,-53,False
1,765,659,540,-119,True
0,676,417,223,-194,True
-1,623,594,-1,-595,True
-1,352,104,613,509,False
1,656,51,752,701,False
0,387,316,213,-103,False
1,428,440,682,242,False
0,466,823,99,-724,False
1,214,669,327,-342,False
0,64,85,724,639,False
-1,356,191,383,192,False
0,949,24,80,56,True
-1,824,691,680,-11,True
0,137,594,268,-326,False
0,554,843,499,-344,False
-1,600,850,487,-363,True
1,840,197,700,503,True
0,904,349,637,288,True
1,507,224,730,506,False
0,689,690,291,-399,True
0,983,934,338,-596,True
-1,568,244,864,620,True
-1,135,667,335,-332,False
0,209,652,36,-616,False
1,75,380,1006,626,False
-1,904,878,169,-709,True
-1,725,246,132,-114,True
0,161,519,15,-504,False
-1,417,970,-37,-1007,False
-1,354,320,-17,-337,False
0,766,604,543,-61,True
1,571,189,899,710,False
1,809,221,832,611,True
-1,905,790,394,-396,True
-1,769,111,897,786,True
0,572,175,512,337,True
-1,963,638,121,-517,True
-1,100,184,-21,-205,False
-1,388,10,671,661,False
-1,7,913,859,-54,False
-1,108,772,-98,-870,False
0,701,509,937,428,True
1,406,279,113,-166,False
1,508,616,1025,409,False
1,722,189,887,698,True
0,724,597,825,228,True
-1,505,666,767,101,True
0,8,922,335,-587,False
0,451,72,217,145,False
-1,814,734,185,-549,True
-1,438,14,416,402,True
1,689,528,423,-105,True
-1,978,64,-83,-147,True
-1,536,432,628,196,True
-1,810,540,791,251,True
0,139,777,17,-760,False
0,427,100,864,764,False
0,5,76,622,546,False
1,179,878,316,-562,False
1,853,516,257,-259,True
-1,350,849,5,-844,False
-1,207,403,415,12,False
0,273,327,353,26,False
-1,461,760,167,-593,False
0,969,546,874,328,True
0,684,111,773,662,True
1,366,225,364,139,False
0,112,293,879,586,False
1,588,393,786,393,False
-1,868,55,298,243,True
0,105,907,640,-267,False
0,832,205,78,-127,True
1,31,419,577,158,False
-1,578,253,546,293,True
1,47,336,574,238,False
-1,678,34,-57,-91,True
0,169,821,303,-518,False
-1,1,605,246,-359,False
-1,524,195,-94,-289,True
1,590,867,532,-335,False
1,717,892,635,-257,True
1,882,816,194,-622,True
1,963,82,788,706,True
1,547,613,808,195,False
0,79,155,349,194,False
1,79,203,164,-39,False
1,544,414,666,252,False
1,396,635,332,-303,False
0,189,299,730,431,False
1,830,467,691,224,True
-1,556,997,807,-190,True
-1,106,750,216,-534,False
0,10,978,645,-333,False
0,323,365,445,80,False
1,705,115,800,685,True
-1,175,660,165,-495,False
0,845,570,944,374,True
1,370,385,305,-80,False
1,704,448,137,-311,True
-1,788,730,548,-182,True
0,666,444,473,29,True
0,839,58,456,398,True
1,788,94,649,555,True
-1,510,526,407,-119,True
-1,642,181,184,3,True
1,595,984,340,-644,False
1,721,212,793,581,True
-1,87,548,270,-278,False
-1,18,429,-16,-445,False
0,369,133,212,79,False
0,114,391,579,188,False
0,264,64,293,229,False
-1,4,822,734,-88,False
0,284,205,523,318,False
1,281,376,847,471,False
-1,744,177,211,34,True
-1,851,358,589,231,True
0,504,884,758,-126,False
-1,842,645,387,-258,True
0,552,839,35,-804,True
1,733,706,950,244,True
0,362,639,207,-432,False
0,196,289,663,374,False
-1,36,934,-4,-938,False
-1,644,666,437,-229,True
-1,118,399,66,-333,False
1,60,990,593,-397,False
-1,287,776,560,-216,False
-1,863,245,-28,-273,True
-1,395,849,827,-22,False
0,965,176,357,181,True
1,344,572,746,174,False
-1,371,627,659,32,False
1,610,147,393,246,False
-1,649,513,104,-409,True
-1,326,560,503,-57,False
1,971,647,485,-162,True
0,70,106,173,67,False
-1,48,105,15,-90,False
1,571,335,362,27,False
1,529,138,483,345,False
0,733,190,861,671,True
-1,704,990,576,-414,True
1,826,230,905,675,True
-1,577,933,503,-430,True
-1,604,796,107,-689,True
-1,849,596,181,-415,True
-1,326,194,339,145,False
0,962,324,748,424,True
1,957,433,369,-64,True
0,250,482,493,11,False
0,328,194,488,294,False
-1,45,614,388,-226,False
0,401,140,89,-51,False
-1,134,986,470,-516,False
0,967,665,574,-91,True
0,611,862,476,-386,True
0,304,977,777,-200,False
1,493,20,196,176,False
0,729,443,457,14,True
0,803,458,864,406,True
0,56,374,288,-86,False
0,401,5,597,592,False
1,160,302,662,360,False
0,238,171,842,671,False
0,87,383,630,247,False
0,796,823,660,-163,True
0,614,507,412,-95,True
1,911,423,529,106,True
1,728,429,138,-291,True
0,803,583,951,368,True
1,649,432,464,32,False
0,951,319,537,218,True
0,253,85,537,452,False
0,466,961,183,-778,False
1,510,6,604,598,False
0,879,371,370,-1,True
1,347,618,979,361,False
-1,158,911,846,-65,False
0,653,663,469,-194,True
-1,790,61,330,269,True
0,13,20,966,946,False
1,110,212,908,696,False
-1,869,743,387,-356,True
1,715,896,395,-501,True
1,306,299,722,423,False
-1,786,990,711,-279,True
1,631,226,842,616,False
0,996,619,195,-424,True
0,535,731,93,-638,False
0,94,416,798,382,False
1,79,115,689,574,False
0,668,337,340,3,True
0,622,232,391,159,True
-1,27,830,142,-688,False
0,317,1,918,917,False
1,118,727,467,-260,False
0,213,957,543,-414,False
0,950,638,520,-118,True
0,887,30,220,190,True
1,100,24,1024,1000,False
0,303,910,486,-424,False
1,275,100,820,720,False
-1,458,309,317,8,True
0,322,631,95,-536,False
0,211,529,255,-274,False
1,953,348,271,-77,True
1,284,545,853,308,False
0,879,861,200,-661,True
-1,71,435,358,-77,False
0,646,582,103,-479,True
-1,745,730,333,-397,True
-1,797,602,753,151,True
1,110,256,597,341,False
1,353,404,264,-140,False
1,723,500,566,66,True
0,897,104,439,335,True
0,480,895,345,-550,False
-1,424,836,798,-38,False
0,208,822,78,-744,False
0,753,262,42,-220,True
1,37,503,432,-71,False
-1,534,674,576,-98,True
0,239,62,280,218,False
-1,59,106,401,295,False
-1,743,750,575,-175,True
0,272,949,265,-684,False
1,531,446,669,223,False
-1,388,9,76,67,False
0,461,14,94,80,False
-1,458,494,-15,-509,False
1,978,292,492,200,True
-1,918,142,296,154,True
1,31,238,748,510,False
-1,861,350,528,178,True
0,258,379,616,237,False
0,889,678,923,245,True
0,578,105,127,22,True
-1,785,788,217,-571,True
-1,572,113,423,310,True
0,423,176,367,191,False
0,248,57,435,378,False
0,804,272,374,102,True
-1,970,742,484,-258,True
0,633,344,766,422,True
-1,341,227,50,-177,False
-1,593,808,639,-169,True
1,295,131,382,251,False
1,287,79,957,878,False
-1,435,796,834,38,True
1,778,122,185,63,True
0,56,233,54,-179,False
1,655,476,470,-6,True
0,293,955,446,-509,False
0,455,111,68,-43,False
0,180,509,942,433,False
0,905,216,202,-14,True
1,622,42,440,398,False
0,187,636,909,273,False
1,716,685,613,-72,True
1,317,898,595,-303,False
1,147,644,107,-537,False
1,534,338,458,120,False
0,704,342,596,254,True
0,663,105,210,105,True
1,298,835,164,-671,False
-1,463,505,431,-74,False
1,86,349,249,-100,False
-1,104,419,212,-207,False
1,868,136,140,4,True
1,585,160,419,259,False
1,582,34,567,533,False
1,62,83,1052,969,False
1,90,234,953,719,False
1,31,987,1029,42,False
1,347,326,830,504,False
1,87,255,378,123,False
1,348,351,460,109,False
-1,312,457,785,328,False
1,884,790,584,-206,True
-1,745,828,197,-631,True
0,81,745,974,229,False
-1,914,437,821,384,True
0,954,287,745,458,True
-1,570,598,69,-529,True
1,3,8,239,231,False
1,197,999,191,-808,False
1,934,513,123,-390,True
-1,628,607,727,120,True
-1,792,377,604,227,True
1,303,206,602,396,False
0,340,651,862,211,False
0,168,898,205,-693,False
0,36,193,214,21,False
1,517,29,766,737,False
0,219,396,779,383,False
0,764,851,482,-369,True
0,327,732,168,-564,False
0,780,774,648,-126,True
-1,693,368,365,-3,True
0,425,245,510,265,False
0,300,862,645,-217,False
1,224,60,643,583,False
-1,484,429,673,244,True
-1,739,3,503,500,True
0,408,326,670,344,False
-1,608,509,50,-459,True
1,754,921,1069,148,True
0,940,169,119,-50,True
1,501,861,500,-361,False
0,151,137,972,835,False
0,219,854,203,-651,False
-1,466,379,668,289,True
-1,874,461,11,-450,True
-1,966,312,573,261,True
-1,401,921,892,-29,False
0,699,105,275,170,True
-1,392,780,806,26,False
1,928,57,115,58,True
0,51,159,835,676,False
0,734,521,914,393,True
1,330,586,935,349,False
1,746,192,785,593,True
0,663,536,743,207,True
1,781,837,284,-553,True
1,763,902,724,-178,True
-1,62,797,443,-354,False
1,133,266,763,497,False
0,504,121,39,-82,False
1,171,824,345,-479,False
-1,177,542,831,289,False
-1,346,940,81,-859,False
-1,955,689,345,-344,True
0,868,742,390,-352,True
1,494,934,371,-563,False
0,273,618,814,196,False
1,976,745,1098,353,True
1,343,289,579,290,False
0,654,308,319,11,True
0,365,242,480,238,False
-1,897,271,566,295,True
-1,240,91,514,423,False
0,880,930,111,-819,True
0,530,925,187,-738,False
-1,409,324,638,314,False
0,406,768,392,-376,False
0,124,813,947,134,False
-1,931,417,182,-235,True
-1,930,835,243,-592,True
-1,86,831,123,-708,False
1,143,662,995,333,False
0,16,828,182,-646,False
1,797,809,1038,229,True
-1,518,525,355,-170,True
1,559,387,344,-43,False
1,556,67,562,495,False
0,871,213,279,66,True
1,137,22,748,726,False
1,245,696,123,-573,False
1,785,995,539,-456,True
0,608,774,899,125,True
0,610,619,588,-31,True
1,557,857,265,-592,False
-1,108,990,397,-593,False
-1,23,717,834,117,False
0,214,950,944,-6,False
0,134,600,603,3,False
1,386,341,149,-192,False
0,806,536,35,-501,True
1,433,275,584,309,False
0,628,436,642,206,True
-1,753,354,37,-317,True
-1,53,472,110,-362,False
-1,685,194,797,603,True
0,78,231,992,761,False
0,510,573,299,-274,False
0,905,88,482,394,True
1,683,281,378,97,True
-1,726,854,620,-234,True
0,996,169,295,126,True
1,210,830,854,24,False
0,825,910,140,-770,True
-1,595,20,433,413,True
0,431,660,577,-83,False
0,430,668,111,-557,False
0,340,587,889,302,False
0,290,188,306,118,False
-1,240,984,267,-717,False
-1,499,377,-35,-412,True
1,48,708,406,-302,False
-1,788,767,839,72,True
1,786,431,166,-265,True
-1,210,662,-84,-746,False
0,465,431,973,542,False
1,338,270,263,-7,False
0,86,915,451,-464,False
0,655,743,680,-63,True
1,569,859,403,-456,False
1,481,342,433,91,False
1,173,637,1082,445,False
0,838,572,79,-493,True
0,196,760,163,-597,False
-1,797,575,493,-82,True
1,232,871,363,-508,False
0,116,391,590,199,False
1,960,302,1071,769,True
-1,665,993,667,-326,True
1,758,500,939,439,True
0,210,382,268,-114,False
0,180,817,908,91,False
-1,159,378,222,-156,False
-1,901,196,386,190,True
1,994,850,601,-249,True
0,576,198,353,155,True
0,886,98,225,127,True
0,540,682,322,-360,False
0,515,714,972,258,False
1,825,982,799,-183,True
-1,804,848,292,-556,True
-1,762,493,-61,-554,True
-1,261,352,769,417,False
1,970,678,654,-24,True
-1,203,474,354,-120,False
1,199,93,865,772,False
1,274,512,614,102,False
1,656,437,682,245,True
-1,706,677,438,-239,True
1,320,274,954,680,False
1,566,724,419,-305,False
0,802,189,565,376,True
1,921,620,550,-70,True
-1,645,491,780,289,True
0,683,927,399,-528,True
1,602,665,594,-71,False
-1,911,696,578,-118,True
0,162,837,785,-52,False
1,292,815,1006,191,False
1,972,47,715,668,True
1,123,672,407,-265,False
0,711,956,13,-943,True
-1,150,804,734,-70,False
0,825,428,995,567,True
0,949,831,72,-759,True
1,163,756,941,185,False
1,824,348,825,477,True
-1,501,316,686,370,True
0,89,513,327,-186,False
1,256,364,655,291,False
1,939,44,1018,974,True
0,994,424,970,546,True
0,730,17,371,354,True
1,485,257,549,292,False
0,15,37,245,208,False
1,654,943,1044,101,False
0,186,708,889,181,False
0,989,286,563,277,True
1,472,638,142,-496,False
-1,484,315,503,188,True
-1,956,718,769,51,True
1,551,457,280,-177,False
1,343,36,153,117,False
0,880,81,791,710,True
0,608,11,8,-3,True
1,948,205,655,450,True
-1,665,833,-62,-895,True
1,674,633,222,-411,False
-1,954,207,827,620,True
1,356,402,312,-90,False
0,371,817,741,-76,False
-1,669,165,861,696,True
-1,268,857,-29,-886,False
0,922,988,195,-793,True
1,552,985,1046,61,False
1,297,541,817,276,False
-1,19,310,887,577,False
-1,305,502,895,393,False
1,702,318,874,556,True
-1,855,733,-66,-799,True
1,871,318,879,561,True
1,870,303,640,337,True
1,75,236,164,-72,False
0,615,99,79,-20,True
1,51,755,675,-80,False
0,857,981,821,-160,True
0,927,139,254,115,True
0,568,973,645,-328,False
-1,553,863,80,-783,True
-1,146,473,627,154,False
1,914,506,328,-178,True
0,692,561,460,-101,True
-1,902,575,653,78,True
0,343,287,854,567,False
-1,524,772,783,11,True
-1,583,774,386,-388,True
0,631,980,393,-587,True
0,500,581,171,-410,False
0,781,457,649,192,True
1,983,282,838,556,True
1,577,1,718,717,False
-1,442,941,280,-661,False
0,623,498,419,-79,True
1,10,796,162,-634,False
-1,659,348,393,45,True
1,672,872,724,-148,True
-1,6,774,714,-60,False
-1,471,841,378,-463,True
0,680,699,129,-570,True
1,588,184,984,800,False
0,403,889,749,-140,False
1,459,322,733,411,False
1,187,211,297,86,False
0,751,268,203,-65,True
0,798,212,196,-16,True
1,220,420,1024,604,False
1,631,99,834,735,False
-1,36,687,652,-35,False
-1,823,364,719,355,True
1,846,341,490,149,True
-1,206,106,772,666,False
1,210,419,678,259,False
1,609,528,1062,534,False
1,876,938,670,-268,True
1,797,809,1028,219,True
0,786,323,331,8,True
1,70,968,1001,33,False
0,747,371,671,300,True
0,958,290,186,-104,True
-1,533,556,812,256,True
1,651,173,578,405,True
-1,176,616,726,110,False
1,685,996,769,-227,True
0,796,914,995,81,True
-1,654,836,45,-791,True
1,490,263,1059,796,False
0,693,215,461,246,True
1,565,935,1029,94,False
1,100,696,853,157,False
1,138,240,134,-106,False
-1,467,219,384,165,True
1,293,55,494,439,False
-1,918,429,379,-50,True
-1,282,990,405,-585,False
0,466,26,246,220,False
-1,648,939,22,-917,True
-1,529,548,649,101,True
1,773,653,886,233,True
1,866,679,253,-426,True
1,397,203,145,-58,False
0,763,566,690,124,True
-1,559,486,276,-210,True
-1,453,632,293,-339,False
-1,294,863,722,-141,False
0,270,894,639,-255,False
1,100,683,849,166,False
1,730,482,778,296,True
1,606,170,164,-6,False
-1,248,648,124,-524,False
1,998,726,822,96,True
-1,461,382,497,115,True
-1,86,399,225,-174,False
0,429,848,115,-733,False
-1,764,567,185,-382,True
0,610,936,801,-135,True
-1,247,392,236,-156,False
-1,176,509,-12,-521,False
-1,965,48,495,447,True
1,913,204,422,218,True
1,910,691,951,260,True
0,385,291,172,-119,False
1,491,295,958,663,False
0,631,663,459,-204,True
0,263,845,531,-314,False
-1,363,402,101,-301,False
0,81,241,711,470,False
0,465,72,267,195,False
1,5,716,894,178,False
1,622,502,440,-62,False
1,258,103,356,253,False
1,965,64,1011,947,True
1,2,991,797,-194,False
-1,541,425,185,-240,True
1,388,461,233,-228,False
1,785,924,752,-172,True
0,293,989,763,-226,False
1,463,34,129,95,False
-1,94,403,657,254,False
1,750,280,883,603,True
1,131,954,457,-497,False
1,605,893,528,-365,False
1,867,562,614,52,True
-1,211,751,-24,-775,False
0,515,602,641,39,False
-1,434,396,200,-196,False
0,278,82,627,545,False
1,976,13,933,920,True
1,160,431,921,490,False
-1,478,773,103,-670,False
-1,406,222,81,-141,False
1,553,709,893,184,False
-1,825,410,734,324,True
1,829,264,510,246,True
1,853,481,377,-104,True
0,803,543,978,435,True
1,973,523,987,464,True
1,389,745,517,-228,False
0,631,726,979,253,True
-1,474,545,724,179,True
0,843,581,799,218,True
1,371,464,830,366,False
-1,836,739,641,-98,True
0,369,151,650,499,False
-1,605,28,73,45,True
0,312,932,200,-732,False
1,62,168,514,346,False
-1,489,741,187,-554,False
0,822,680,769,89,True
1,999,544,936,392,True
1,21,304,1037,733,False
0,75,597,390,-207,False
-1,398,455,30,-425,False
1,177,747,350,-397,False
-1,967,122,-90,-212,True
0,493,253,763,510,False
1,438,126,848,722,False
-1,776,121,7,-114,True
-1,794,986,-84,-1070,True
1,255,702,148,-554,False
0,133,503,780,277,False
1,523,931,378,-553,False
1,328,291,794,503,False
1,727,244,591,347,True
-1,720,967,374,-593,True
-1,440,245,660,415,True
-1,785,729,-17,-746,True
-1,769,380,-88,-468,True
-1,398,325,609,284,False
-1,655,185,295,110,True
0,768,465,741,276,True
1,872,227,117,-110,True
0,764,809,668,-141,True
0,685,306,137,-169,True
-1,449,564,585,21,False
1,4,949,705,-244,False
-1,246,656,-63,-719,False
1,712,164,592,428,True
1,447,837,920,83,False
1,378,276,304,28,False
1,259,350,268,-82,False
1,987,642,752,110,True
1,235,608,243,-365,False
0,881,691,622,-69,True
-1,375,114,368,254,False
1,676,848,379,-469,False
-1,387,587,101,-486,False
1,599,395,829,434,False
1,298,897,650,-247,False
-1,543,611,-28,-639,True
-1,752,951,390,-561,True
-1,510,185,53,-132,True
-1,982,319,230,-89,True
-1,717,192,373,181,True
-1,612,546,500,-46,True
1,402,204,900,696,False
-1,201,633,305,-328,False
1,421,644,576,-68,False
0,641,118,63,-55,True
-1,474,434,664,230,True
1,518,613,124,-489,False
1,252,448,365,-83,False
0,498,336,309,-27,False
0,22,815,215,-600,False
-1,707,364,291,-73,True
-1,321,65,111,46,False
-1,789,50,530,480,True
0,787,726,199,-527,True
1,289,221,1012,791,False
0,317,813,225,-588,False
-1,723,376,590,214,True
0,780,112,720,608,True
0,661,943,248,-695,True
1,437,546,495,-51,False
-1,229,982,546,-436,False
0,604,610,465,-145,True
0,119,751,895,144,False
-1,42,87,-68,-155,False
0,571,148,485,337,False
0,887,67,113,46,True
1,379,35,342,307,False
0,635,957,959,2,True
0,413,697,119,-578,False
1,835,130,834,704,True
1,678,167,363,196,True
-1,794,38,642,604,True
1,723,254,295,41,True
0,760,589,349,-240,True
1,855,101,946,845,True
0,988,978,212,-766,True
-1,234,663,-10,-673,False
0,784,797,126,-671,True
1,982,863,263,-600,True
1,523,197,440,243,False
-1,946,47,249,202,True
-1,144,819,272,-547,False
1,264,310,878,568,False
-1,327,607,-15,-622,False
-1,973,616,846,230,True
0,724,272,774,502,True
-1,68,52,640,588,False
1,250,186,547,361,False
1,690,218,643,425,True
1,581,850,604,-246,False
0,410,76,673,597,False
0,879,305,133,-172,True
-1,424,689,345,-344,False
0,514,206,377,171,False
-1,137,606,17,-589,False
0,450,233,65,-168,False
1,637,14,443,429,True
1,497,848,1091,243,False
0,36,91,927,836,False
-1,639,998,349,-649,True
1,816,927,590,-337,True
0,458,201,76,-125,False
-1,83,930,427,-503,False
1,939,71,991,920,True
0,430,430,713,283,False
-1,784,339,806,467,True
1,491,622,211,-411,False
0,41,340,161,-179,False
-1,370,700,457,-243,False
0,175,592,99,-493,False
1,167,926,805,-121,False
0,904,905,896,-9,True
1,813,380,987,607,True
-1,925,735,50,-685,True
-1,747,953,10,-943,True
1,607,595,904,309,False
-1,342,549,833,284,False
-1,676,685,263,-422,True
1,622,425,239,-186,False
-1,702,947,838,-109,True
1,491,864,922,58,False
0,589,16,416,400,False
0,784,892,97,-795,True
1,237,988,896,-92,False
1,905,998,566,-432,True
-1,426,264,20,-244,False
0,91,577,77,-500,False
1,505,625,301,-324,False
0,927,490,355,-135,True
1,521,42,756,714,False
0,191,208,678,470,False
0,429,953,749,-204,False
-1,70,950,473,-477,False
-1,416,367,246,-121,False
0,318,437,898,461,False
-1,954,707,562,-145,True
1,534,108,819,711,False
1,737,535,896,361,True
0,491,110,69,-41,False
-1,316,156,378,222,False
-1,639,275,755,480,True
0,845,680,702,22,True
1,101,751,908,157,False
-1,681,922,454,-468,True
-1,729,552,873,321,True
1,453,929,933,4,False
-1,177,842,206,-636,False
1,17,810,429,-381,False
0,582,783,687,-96,True
1,167,384,995,611,False
1,436,570,425,-145,False
0,389,42,957,915,False
-1,860,327,558,231,True
1,46,265,1002,737,False
1,831,448,489,41,True
1,19,607,343,-264,False
-1,523,438,88,-350,True
-1,781,687,800,113,True
1,927,959,685,-274,True
0,211,620,712,92,False
-1,359,528,-90,-618,False
0,465,320,890,570,False
1,183,555,351,-204,False
0,961,975,904,-71,True
1,863,380,899,519,True
0,464,338,249,-89,False
1,916,24,859,835,True
1,949,767,263,-504,True
0,778,473,333,-140,True
0,524,246,552,306,False
1,979,452,484,32,True
-1,41,370,637,267,False
-1,138,521,630,109,False
-1,378,656,289,-367,False
0,871,566,174,-392,True
0,151,832,378,-454,False
-1,448,992,842,-150,False
-1,19,338,200,-138,False
0,135,337,960,623,False
-1,748,865,151,-714,True
1,332,506,224,-282,False
0,172,171,921,750,False
-1,426,584,166,-418,False
1,462,214,730,516,False
-1,126,230,149,-81,False
1,23,855,824,-31,False
1,568,896,949,53,False
-1,966,105,-98,-203,True
-1,49,278,524,246,False
-1,555,339,-85,-424,True
-1,647,313,295,-18,True
-1,323,970,202,-768,False
-1,515,353,452,99,True
1,873,59,813,754,True
1,265,151,839,688,False
0,302,730,12,-718,False
0,772,821,8,-813,True
0,213,180,495,315,False
-1,655,660,659,-1,True
-1,986,309,714,405,True
-1,66,37,257,220,False
0,341,750,18,-732,False
1,58,920,597,-323,False
1,126,787,1051,264,False
-1,842,7,811,804,True
0,590,401,980,579,True
-1,974,804,867,63,True
0,96,591,638,47,False
0,167,26,783,757,False
-1,216,149,224,75,False
0,580,366,295,-71,True
1,334,290,877,587,False
-1,321,968,683,-285,False
1,100,1,1096,1095,False
-1,135,344,222,-122,False
1,280,19,267,248,False
0,559,779,675,-104,True
-1,429,678,528,-150,False
0,143,795,773,-22,False
-1,677,694,873,179,True
1,206,728,506,-222,False
1,929,131,352,221,True
1,260,308,982,674,False
1,105,54,295,241,False
-1,976,428,6,-422,True
-1,444,497,844,347,False
1,26,807,540,-267,False
0,452,238,600,362,False
-1,861,859,834,-25,True
0,920,635,708,73,True
-1,449,210,-28,-238,True
1,532,441,170,-271,False
-1,704,639,850,211,True
1,427,710,237,-473,False
-1,737,691,832,141,True
-1,375,113,521,408,False
1,774,183,321,138,True
1,666,402,118,-284,True
0,163,705,23,-682,False
-1,789,253,560,307,True
0,228,197,349,152,False
1,21,388,304,-84,False
-1,193,156,-26,-182,False
0,904,210,363,153,True
1,609,25,705,680,False
1,998,958,772,-186,True
-1,305,832,804,-28,False
-1,501,685,605,-80,True
0,178,541,201,-340,False
1,83,749,421,-328,False
1,821,550,335,-215,True
1,808,172,986,814,True
1,683,81,168,87,False
0,599,756,76,-680,True
0,901,438,258,-180,True
1,1,583,1027,444,False
-1,928,660,290,-370,True
-1,331,877,348,-529,False
0,148,389,158,-231,False
0,109,449,364,-85,False
-1,960,869,-18,-887,True
-1,701,120,207,87,True
-1,172,384,343,-41,False
0,494,891,153,-738,False
1,734,132,437,305,True
-1,962,506,187,-319,True
0,769,92,264,172,True
0,253,646,554,-92,False
-1,833,481,659,178,True
-1,463,790,340,-450,False
-1,583,82,-46,-128,True
-1,323,786,439,-347,False
1,498,828,648,-180,False
-1,789,395,-34,-429,True
1,269,991,447,-544,False
-1,769,317,724,407,True
-1,740,932,28,-904,True
0,718,781,329,-452,True
0,521,7,968,961,False
0,226,762,592,-170,False
1,634,760,521,-239,True
-1,578,56,254,198,True
0,590,371,751,380,True
-1,585,953,670,-283,True
1,446,142,235,93,False
-1,52,86,779,693,False
0,97,382,468,86,False
0,880,884,627,-257,True
-1,273,959,494,-465,False
1,910,203,392,189,True
-1,507,472,51,-421,True
0,657,716,985,269,True
1,149,903,757,-146,False
-1,38,456,444,-12,False
0,663,492,856,364,True
1,428,391,602,211,False
-1,470,304,198,-106,True
0,66,961,367,-594,False
-1,355,175,823,648,False
1,611,958,349,-609,False
-1,671,665,36,-629,True
1,697,21,919,898,True
0,236,545,875,330,False
1,616,72,114,42,False
0,125,106,776,670,False
1,54,911,142,-769,False
1,339,413,618,205,False
0,987,872,896,24,True
0,185,454,362,-92,False
0,788,819,206,-613,True
-1,350,350,879,529,False
-1,835,659,372,-287,True
1,96,813,894,81,False
-1,890,926,453,-473,True
-1,434,787,233,-554,False
1,681,860,754,-106,True
-1,149,447,93,-354,False
0,120,928,543,-385,False
-1,929,814,352,-462,True
0,659,666,989,323,True
1,53,494,863,369,False
0,85,683,486,-197,False
0,206,362,213,-149,False
0,377,560,222,-338,False
1,153,242,694,452,False
-1,51,844,541,-303,False
-1,784,399,570,171,True
0,16,840,158,-682,False
0,981,294,709,415,True
-1,266,864,261,-603,False
-1,896,775,96,-679,True
-1,613,925,846,-79,True
-1,571,814,315,-499,True
0,716,962,254,-708,True
-1,27,24,349,325,False
-1,286,750,576,-174,False
0,432,862,103,-759,False
-1,708,591,580,-11,True
0,714,867,54,-813,True
-1,891,18,882,864,True
0,595,256,451,195,True
0,226,558,115,-443,False
0,855,870,980,110,True
0,444,281,19,-262,False
1,566,78,255,177,False
1,336,83,224,141,False
1,168,484,1046,562,False
1,8,441,719,278,False
-1,940,238,720,482,True
1,946,276,647,371,True
0,728,881,309,-572,True
0,684,639,728,89,True
1,926,639,153,-486,True
-1,508,451,349,-102,True
1,118,106,864,758,False
1,245,231,1050,819,False
-1,316,894,-37,-931,False
0,249,436,742,306,False
1,70,512,150,-362,False
-1,990,820,159,-661,True
-1,301,60,26,-34,False
1,735,293,580,287,True
-1,414,609,562,-47,False
1,31,817,693,-124,False
0,411,237,536,299,False
0,582,80,232,152,True
0,984,754,115,-639,True
-1,328,241,638,397,False
0,845,266,154,-112,True
1,972,739,849,110,True
-1,543,701,455,-246,True
1,239,557,108,-449,False
1,447,840,981,141,False
0,443,584,468,-116,False
1,894,397,211,-186,True
1,207,598,1044,446,False
1,376,131,440,309,False
1,726,561,957,396,True
-1,451,472,125,-347,False
-1,4,222,822,600,False
1,108,824,592,-232,False
0,360,286,316,30,False
-1,565,348,-72,-420,True
0,745,675,414,-261,True
0,517,241,713,472,False
1,28,473,968,495,False
1,723,181,362,181,True
-1,347,927,556,-371,False
-1,623,333,316,-17,True
0,272,985,507,-478,False
0,78,655,257,-398,False
-1,565,419,504,85,True
-1,113,441,518,77,False
0,977,92,22,-70,True
0,467,278,470,192,False
0,560,377,545,168,False
0,69,954,528,-426,False
1,102,173,1068,895,False
-1,646,754,272,-482,True
1,164,664,231,-433,False
0,723,717,856,139,True
-1,701,208,157,-51,True
1,51,292,733,441,False
-1,335,211,-73,-284,False
0,729,975,605,-370,True
-1,141,78,792,714,False
0,815,765,34,-731,True
-1,808,85,604,519,True
1,918,550,406,-144,True
-1,89,491,498,7,False
1,407,846,828,-18,False
0,840,774,570,-204,True
1,739,630,783,153,True
1,189,661,755,94,False
-1,616,20,-36,-56,True
-1,977,963,865,-98,True
-1,15,161,754,593,False
-1,935,557,-6,-563,True
0,566,810,833,23,False
0,913,763,595,-168,True
-1,89,257,-8,-265,False
-1,204,940,633,-307,False
1,495,383,652,269,False
1,988,462,153,-309,True
0,47,561,557,-4,False
-1,643,157,403,246,True
1,761,35,524,489,True
-1,639,5,787,782,True
0,23,109,106,-3,False
-1,693,498,-22,-520,True
1,775,128,683,555,True
-1,745,258,-9,-267,True
-1,800,471,513,42,True
0,420,209,405,196,False
0,51,851,13,-838,False
0,530,330,351,21,True
1,965,553,824,271,True
0,529,74,250,176,True
0,834,898,172,-726,True
-1,234,87,-63,-150,False
0,47,579,956,377,False
-1,461,861,-66,-927,False
-1,192,663,722,59,False
0,676,332,807,475,True
1,177,404,259,-145,False
0,775,93,688,595,True
-1,816,392,-66,-458,True
-1,736,541,33,-508,True
1,742,848,395,-453,True
0,514,594,669,75,False
-1,571,91,709,618,True
-1,122,984,251,-733,False
0,204,872,660,-212,False
0,475,777,619,-158,False
1,492,878,153,-725,False
1,173,816,902,86,False
1,861,442,1095,653,True
1,957,824,213,-611,True
0,500,618,741,123,False
-1,532,851,21,-830,True
0,235,428,918,490,False
-1,812,629,278,-351,True
0,262,834,743,-91,False
0,862,614,827,213,True
1,218,576,485,-91,False
1,374,6,190,184,False
0,344,101,913,812,False
0,160,943,490,-453,False
-1,968,388,185,-203,True
0,520,696,82,-614,False
-1,644,63,-33,-96,True
1,492,626,200,-426,False
1,789,608,405,-203,True
0,847,131,483,352,True
0,115,588,160,-428,False
1,43,499,203,-296,False
0,648,650,591,-59,True
0,328,484,245,-239,False
0,25,777,511,-266,False
1,416,1000,294,-706,False
-1,922,831,519,-312,True
0,356,430,3,-427,False
0,143,642,631,-11,False
1,574,61,740,679,False
0,656,884,830,-54,True
-1,189,555,13,-542,False
0,716,483,715,232,True
-1,808,341,495,154,True
0,962,899,669,-230,True
1,839,482,734,252,True
0,898,400,437,37,True
-1,161,130,190,60,False
-1,564,704,376,-328,True
0,397,113,813,700,False
-1,225,273,477,204,False
1,855,714,481,-233,True
-1,784,922,571,-351,True
0,657,392,996,604,True
1,68,790,678,-112,False
1,342,5,144,139,False
-1,623,917,778,-139,True
0,805,891,132,-759,True
0,931,454,783,329,True
-1,646,847,872,25,True
1,823,619,700,81,True
1,587,573,194,-379,False
0,905,834,569,-265,True
0,948,248,331,83,True
-1,989,312,385,73,True
0,549,575,521,-54,True
1,914,186,447,261,True
1,68,734,573,-161,False
-1,123,453,233,-220,False
1,904,676,1052,376,True
0,888,145,259,114,True
-1,562,685,766,81,True
0,829,710,796,86,True
-1,909,983,223,-760,True
-1,489,525,367,-158,False
0,747,399,448,49,True
1,87,979,163,-816,False
0,78,292,156,-136,False
0,443,458,857,399,False
0,968,545,499,-46,True
-1,543,390,139,-251,True
-1,35,730,343,-387,False
1,226,125,616,491,False
-1,662,903,-97,-1000,True
0,544,92,238,146,True
1,146,494,618,124,False
1,618,23,906,883,False
1,504,584,666,82,False
1,614,736,340,-396,False
1,714,138,116,-22,True
1,394,351,269,-82,False
-1,240,154,779,625,False
1,164,151,223,72,False
0,449,520,593,73,False
0,508,919,643,-276,False
0,777,639,659,20,True
1,834,409,870,461,True
0,305,237,959,722,False
-1,654,351,77,-274,True
1,716,798,1026,228,True
-1,992,564,580,16,True
0,502,687,873,186,False
1,908,31,240,209,True
0,122,691,557,-134,False
0,827,470,327,-143,True
-1,451,589,222,-367,True
-1,141,201,451,250,False
0,822,899,906,7,True
-1,323,230,351,121,False
1,777,150,993,843,True
0,857,456,948,492,True
0,320,557,69,-488,False
-1,61,833,54,-779,False
-1,577,857,541,-316,True
0,368,858,479,-379,False
0,81,267,750,483,False
-1,821,630,694,64,True
1,585,876,525,-351,False
1,625,558,1071,513,True
0,556,66,774,708,False
-1,704,921,508,-413,True
-1,634,519,764,245,True
1,348,352,959,607,False
-1,689,434,-86,-520,True
0,857,926,37,-889,True
-1,703,387,97,-290,True
1,337,662,923,261,False
0,800,623,461,-162,True
1,170,843,820,-23,False
1,103,784,261,-523,False
0,441,58,318,260,False
0,347,232,314,82,False
1,845,382,961,579,True
1,473,452,164,-288,False
1,52,616,716,100,False
1,926,973,565,-408,True
-1,878,283,125,-158,True
1,407,270,379,109,False
1,784,333,509,176,True
-1,171,172,479,307,False
1,447,808,208,-600,False
0,545,196,530,334,True
0,96,249,520,271,False
0,750,775,771,-4,True
1,991,188,301,113,True
0,611,184,79,-105,True
1,44,590,522,-68,False
0,647,229,2,-227,True
-1,783,925,623,-302,True
-1,485,356,557,201,True
1,526,435,688,253,False
1,689,533,564,31,True
-1,946,234,469,235,True
1,966,916,198,-718,True
-1,373,471,736,265,False
0,535,364,18,-346,False
0,255,357,219,-138,False
-1,53,66,604,538,False
0,586,363,692,329,True
1,301,66,1067,1001,False
0,239,859,349,-510,False
0,460,435,900,465,False
1,373,589,870,281,False
-1,218,236,315,79,False
1,411,302,628,326,False
1,82,981,265,-716,False
0,703,947,53,-894,True
0,800,445,105,-340,True
1,508,733,870,137,False
0,480,760,468,-292,False
-1,842,15,252,237,True
1,886,959,382,-577,True
0,511,316,102,-214,False
-1,298,471,-92,-563,False
1,275,851,980,129,False
0,689,82,990,908,True
0,65,304,153,-151,False
1,789,906,514,-392,True
1,255,981,386,-595,False
-1,35,705,202,-503,False
1,273,788,981,193,False
0,310,147,617,470,False
-1,99,454,420,-34,False
1,465,942,273,-669,False
1,849,677,1097,420,True
0,206,182,892,710,False
0,535,445,78,-367,False
-1,427,525,403,-122,False
-1,676,328,301,-27,True
-1,886,434,357,-77,True
1,85,844,141,-703,False
1,723,803,409,-394,True
-1,820,434,-25,-459,True
0,336,369,920,551,False
-1,564,365,-30,-395,True
-1,965,596,-2,-598,True
0,291,588,452,-136,False
0,883,936,746,-190,True
-1,253,659,669,10,False
-1,791,875,805,-70,True
1,861,632,775,143,True
-1,855,313,720,407,True
-1,87,373,220,-153,False
0,780,63,784,721,True
1,576,203,503,300,False
-1,293,287,166,-121,False
-1,655,616,499,-117,True
1,399,442,848,406,False
1,51,364,560,196,False
1,84,671,540,-131,False
1,603,20,113,93,False
1,889,109,688,579,True
0,240,666,731,65,False
0,57,418,239,-179,False
1,776,647,1037,390,True
1,83,748,746,-2,False
0,813,244,15,-229,True
-1,193,787,115,-672,False
-1,73,60,421,361,False
1,222,899,715,-184,False
0,340,361,727,366,False
-1,743,8,724,716,True
0,730,942,203,-739,True
0,392,686,714,28,False
0,503,906,728,-178,False
-1,159,147,185,38,False
-1,190,784,216,-568,False
0,461,416,868,452,False
1,813,823,929,106,True
0,884,360,846,486,True
-1,756,845,403,-442,True
1,353,465,537,72,False
1,225,89,1049,960,False
0,347,999,74,-925,False
0,588,355,585,230,True
-1,704,517,-32,-549,True
1,659,879,849,-30,True
0,561,293,408,115,True
-1,194,246,843,597,False
-1,449,234,199,-35,False
-1,372,739,721,-18,False
1,803,389,545,156,True
-1,983,561,645,84,True
0,382,765,443,-322,False
-1,262,271,146,-125,False
0,80,78,970,892,False
0,634,143,66,-77,True
1,958,316,540,224,True
-1,753,481,525,44,True
1,919,220,260,40,True
0,623,882,762,-120,True
0,275,427,116,-311,False
1,385,420,391,-29,False
-1,377,846,347,-499,False
1,84,577,211,-366,False
-1,226,46,595,549,False
0,796,872,790,-82,True
1,766,741,830,89,True
1,22,993,582,-411,False
1,621,152,316,164,False
1,981,984,755,-229,True
-1,841,397,752,355,True
1,574,385,992,607,False
-1,944,64,311,247,True
-1,586,137,-23,-160,True
-1,147,141,445,304,False
0,238,717,34,-683,False
1,124,614,277,-337,False
1,862,338,696,358,True
0,880,541,639,98,True
0,247,566,609,43,False
0,516,694,639,-55,False
1,180,347,276,-71,False
0,713,560,336,-224,True
0,901,793,249,-544,True
0,642,303,643,340,True
1,998,104,189,85,True
1,234,132,122,-10,False
0,211,480,618,138,False
1,376,978,851,-127,False
0,365,496,358,-138,False
1,222,336,783,447,False
1,304,669,533,-136,False
-1,468,810,603,-207,False
0,401,166,74,-92,False
-1,590,325,14,-311,True
-1,509,557,442,-115,True
-1,658,91,755,664,True
-1,917,243,892,649,True
0,800,964,496,-468,True
0,828,734,992,258,True
0,232,396,562,166,False
1,181,707,1011,304,False
-1,693,131,889,758,True
-1,755,594,-77,-671,True
-1,332,716,356,-360,False
1,633,778,413,-365,False
1,616,848,204,-644,False
-1,68,138,830,692,False
-1,815,430,371,-59,True
1,554,282,1086,804,False
1,837,253,399,146,True
0,260,387,722,335,False
1,334,696,893,197,False
-1,574,48,-77,-125,True
-1,705,573,310,-263,True
0,833,449,971,522,True
1,697,185,935,750,True
-1,527,349,-30,-379,True
0,476,239,942,703,False
-1,908,676,742,66,True
1,340,332,116,-216,False
0,887,978,803,-175,True
0,808,299,425,126,True
-1,632,672,225,-447,True
-1,707,321,96,-225,True
0,349,172,176,4,False
0,436,159,43,-116,False
1,375,241,986,745,False
0,144,2,698,696,False
0,157,772,682,-90,False
0,812,228,701,473,True
-1,7,91,154,63,False
-1,893,709,783,74,True
1,145,806,924,118,False
0,411,904,173,-731,False
-1,555,98,8,-90,True
1,160,483,1075,592,False
-1,401,700,818,118,False
-1,859,78,211,133,True
-1,694,643,395,-248,True
0,627,635,189,-446,True
1,179,133,249,116,False
1,561,954,812,-142,False
-1,12,748,846,98,False
1,140,916,259,-657,False
1,455,389,988,599,False
1,995,150,297,147,True
0,794,225,395,170,True
-1,958,31,-59,-90,True
-1,413,922,726,-196,False
0,645,649,939,290,True
-1,460,227,770,543,True
0,249,607,98,-509,False
0,832,128,744,616,True
-1,972,675,-21,-696,True
-1,41,56,732,676,False
0,545,256,373,117,True
1,798,583,288,-295,True
1,17,496,323,-173,False
1,49,488,691,203,False
1,367,806,199,-607,False
1,201,686,109,-577,False
-1,721,296,304,8,True
0,939,963,714,-249,True
0,996,833,3,-830,True
0,13,795,276,-519,False
1,465,608,993,385,False
0,128,564,557,-7,False
1,531,641,260,-381,False
-1,521,445,498,53,True
0,202,221,25,-196,False
1,93,104,447,343,False
1,877,858,419,-439,True
0,546,367,900,533,True
0,977,661,279,-382,True
-1,651,269,878,609,True
-1,939,394,639,245,True
1,122,816,399,-417,False
0,504,417,150,-267,False
-1,501,525,481,-44,True
0,233,72,224,152,False
1,313,333,158,-175,False
0,55,198,592,394,False
-1,709,57,596,539,True
-1,154,588,108,-480,False
1,504,243,516,273,False
1,629,895,704,-191,False
-1,317,290,505,215,False
0,419,845,760,-85,False
-1,166,518,631,113,False
0,214,675,411,-264,False
0,918,468,852,384,True
1,771,805,460,-345,True
1,186,21,502,481,False
-1,309,850,347,-503,False
0,339,924,920,-4,False
-1,255,902,307,-595,False
-1,247,936,9,-927,False
-1,563,831,626,-205,True
-1,853,71,502,431,True
0,217,611,237,-374,False
0,934,167,3,-164,True
1,289,120,1040,920,False
1,546,634,489,-145,False
-1,317,439,580,141,False
1,751,653,388,-265,True
0,919,992,102,-890,True
0,619,923,436,-487,True
1,949,443,514,71,True
1,730,205,456,251,True
-1,682,431,541,110,True
0,253,263,324,61,False
-1,638,748,-50,-798,True
1,398,491,882,391,False
-1,632,626,854,228,True
1,988,924,484,-440,True
0,249,802,964,162,False
0,723,144,809,665,True
-1,512,130,-83,-213,True
-1,35,184,686,502,False
0,765,106,126,20,True
0,63,199,322,123,False
1,847,397,489,92,True
-1,932,639,807,168,True
1,874,508,762,254,True
-1,909,69,895,826,True
0,76,72,240,168,False
-1,528,489,12,-477,True
-1,599,787,128,-659,True
1,517,262,628,366,False
0,540,556,50,-506,True
-1,255,731,369,-362,False
1,404,386,474,88,False
0,238,885,773,-112,False
-1,859,330,579,249,True
-1,29,340,283,-57,False
1,6,377,959,582,False
0,272,468,232,-236,False
0,788,919,805,-114,True
0,231,761,911,150,False
-1,844,158,-28,-186,True
1,774,460,1060,600,True
-1,606,237,734,497,True
-1,520,928,417,-511,True
1,999,252,677,425,True
0,978,340,21,-319,True
1,584,758,1018,260,False
1,582,4,582,578,False
-1,397,249,316,67,False
-1,46,129,290,161,False
0,421,933,944,11,False
0,543,546,368,-178,False
0,470,24,621,597,False
0,476,33,376,343,False
0,598,179,482,303,True
1,720,222,1046,824,True
0,181,108,588,480,False
0,905,748,458,-290,True
-1,433,496,431,-65,True
1,632,667,424,-243,True
1,411,452,1100,648,False
0,945,713,595,-118,True
1,801,12,591,579,True
-1,733,784,505,-279,True
-1,959,184,830,646,True
1,800,411,275,-136,True
1,191,77,674,597,False
0,298,755,333,-422,False
1,976,274,110,-164,True
0,413,335,447,112,False
1,703,568,1010,442,True
-1,109,308,636,328,False
-1,376,791,29,-762,False
1,655,44,815,771,False
0,812,871,501,-370,True
0,894,710,220,-490,True
-1,596,44,819,775,True
-1,920,754,818,64,True
1,388,174,1005,831,False
0,34,479,442,-37,False
0,88,527,924,397,False
0,229,650,418,-232,False
-1,737,294,606,312,True
-1,497,213,486,273,True
-1,496,822,674,-148,False
0,850,130,797,667,True
1,985,248,366,118,True
-1,167,577,227,-350,False
0,661,281,471,190,True
-1,722,577,254,-323,True
1,459,488,1072,584,False
0,137,25,860,835,False
-1,553,106,515,409,True
-1,692,31,173,142,True
1,125,473,1066,593,False
0,130,378,415,37,False
0,747,639,552,-87,True
1,286,874,917,43,False
1,164,717,519,-198,False
-1,118,25,661,636,False
1,54,932,489,-443,False
1,65,128,742,614,False
-1,177,262,492,230,False
-1,896,894,849,-45,True
-1,592,938,623,-315,True
0,164,266,720,454,False
0,164,663,938,275,False
1,879,868,543,-325,True
-1,154,578,402,-176,False
-1,449,102,180,78,False
1,742,273,726,453,True
0,879,10,769,759,True
-1,16,471,450,-21,False
0,79,887,84,-803,False
-1,225,607,240,-367,False
0,42,717,97,-620,False
0,136,458,562,104,False
-1,263,221,292,71,False
1,132,450,344,-106,False
0,402,236,810,574,False
0,717,524,689,165,True
0,526,883,935,52,False
0,239,537,380,-157,False
0,55,37,619,582,False
1,869,393,922,529,True
0,74,471,411,-60,False
-1,856,42,11,-31,True
-1,898,34,-36,-70,True
0,297,338,85,-253,False
-1,962,419,664,245,True
1,176,651,751,100,False
1,412,177,254,77,False
1,513,184,153,-31,False
0,604,165,890,725,True
1,450,98,784,686,False
1,856,150,198,48,True
0,377,400,895,495,False
0,761,121,862,741,True
-1,480,230,783,553,False
1,751,149,877,728,True
1,801,41,514,473,True
1,298,113,1090,977,False
1,998,596,635,39,True
0,382,313,9,-304,False
0,576,717,606,-111,True
-1,854,101,888,787,True
-1,257,480,664,184,False
-1,286,630,297,-333,False
1,899,612,794,182,True
1,613,811,713,-98,True
1,224,468,213,-255,False
1,839,920,650,-270,True
0,378,487,707,220,False
0,302,147,148,1,False
-1,87,98,293,195,False
0,361,664,20,-644,False
-1,439,174,542,368,False
1,315,527,822,295,False
1,660,870,342,-528,True
1,504,255,752,497,False
0,161,849,16,-833,False
1,241,454,1033,579,False
1,540,561,240,-321,False
0,281,10,451,441,False
0,280,793,785,-8,False
-1,289,544,462,-82,False
1,579,984,327,-657,False
-1,353,394,843,449,False
-1,634,377,-10,-387,True
0,988,368,806,438,True
-1,534,235,-70,-305,True
-1,933,966,625,-341,True
1,241,831,1009,178,False
1,545,593,575,-18,False
-1,90,171,318,147,False
0,743,841,465,-376,True
-1,164,326,420,94,False
0,280,712,307,-405,False
-1,288,966,847,-119,False
1,461,371,1051,680,False
0,332,726,533,-193,False
-1,277,697,191,-506,False
1,177,774,128,-646,False
0,833,423,832,409,True
1,630,326,1079,753,False
-1,997,289,161,-128,True
0,106,689,955,266,False
0,768,104,983,879,True
0,838,252,962,710,True
1,278,976,341,-635,False
0,722,121,953,832,True
0,924,675,137,-538,True
-1,761,461,191,-270,True
0,306,559,609,50,False
-1,664,211,181,-30,True
1,580,869,1023,154,False
0,734,979,486,-493,True
-1,782,512,320,-192,True
-1,461,674,194,-480,False
-1,628,22,-2,-24,True
-1,701,504,428,-76,True
1,25,981,366,-615,False
1,279,415,889,474,False
1,879,971,1036,65,True
-1,199,752,129,-623,False
-1,42,930,131,-799,False
0,970,631,30,-601,True
1,849,930,541,-389,True
-1,267,213,369,156,False
1,568,590,114,-476,False
-1,101,45,693,648,False
-1,730,887,155,-732,True
0,589,74,179,105,True
-1,632,814,537,-277,True
-1,375,723,162,-561,False
-1,946,838,804,-34,True
1,278,312,1012,700,False
0,740,405,148,-257,True
-1,11,925,334,-591,False
1,637,708,956,248,False
1,408,46,745,699,False
-1,105,465,-3,-468,False
1,338,531,705,174,False
1,173,237,722,485,False
0,809,889,387,-502,True
0,816,185,345,160,True
-1,11,292,672,380,False
-1,728,865,891,26,True
1,150,579,426,-153,False
1,965,909,973,64,True
0,37,168,785,617,False
0,653,975,746,-229,True
-1,470,878,531,-347,False
0,361,125,167,42,False
1,662,433,399,-34,False
1,306,151,534,383,False
-1,769,667,289,-378,True
0,435,249,119,-130,False
1,742,930,674,-256,True
0,725,616,400,-216,True
-1,359,585,241,-344,False
0,143,203,635,432,False
-1,774,551,180,-371,True
1,400,848,658,-190,False
0,991,491,47,-444,True
-1,912,261,266,5,True
0,882,710,600,-110,True
1,100,741,1060,319,False
0,872,745,76,-669,True
-1,96,107,371,264,False
-1,313,788,863,75,False
0,158,858,733,-125,False
-1,90,537,546,9,False
-1,342,876,820,-56,False
0,685,92,870,778,True
0,140,70,745,675,False
0,921,139,663,524,True
0,868,904,285,-619,True
1,511,109,779,670,False
1,633,764,104,-660,False
1,251,884,755,-129,False
-1,621,620,297,-323,True
0,466,454,551,97,False
1,913,838,253,-585,True
-1,445,740,367,-373,False
-1,234,52,13,-39,False
-1,27,865,59,-806,False
0,566,285,858,573,False
-1,2,863,-1,-864,False
-1,463,182,188,6,True
1,111,180,570,390,False
-1,865,634,817,183,True
-1,434,220,85,-135,False
0,655,441,206,-235,True
-1,268,488,444,-44,False
-1,691,670,108,-562,True
0,796,939,789,-150,True
0,269,675,858,183,False
0,9,459,375,-84,False
1,843,116,972,856,True
-1,254,211,829,618,False
1,442,351,703,352,False
-1,758,190,733,543,True
0,385,91,424,333,False
0,741,1000,606,-394,True
0,578,120,686,566,False
0,833,91,34,-57,True
0,473,367,493,126,False
0,778,407,330,-77,True
0,280,115,664,549,False
0,496,754,968,214,False
1,344,501,485,-16,False
1,414,58,570,512,False
-1,55,19,107,88,False
0,785,68,952,884,True
-1,284,150,80,-70,False
-1,382,108,376,268,False
1,552,745,847,102,False
1,426,143,838,695,False
-1,437,390,322,-68,False
1,528,310,645,335,False
0,911,541,967,426,True
-1,148,936,292,-644,False
1,849,928,261,-667,True
1,589,351,1032,681,False
1,758,942,171,-771,True
1,759,743,910,167,True
1,387,631,929,298,False
-1,320,921,397,-524,False
0,934,650,617,-33,True
0,739,178,145,-33,True
-1,544,130,261,131,True
-1,618,89,-97,-186,True
1,935,652,344,-308,True
0,497,802,804,2,False
1,96,460,1057,597,False
1,227,949,801,-148,False
1,125,994,291,-703,False
-1,293,632,383,-249,False
1,167,909,859,-50,False
-1,109,446,79,-367,False
0,912,781,368,-413,True
-1,662,729,-30,-759,True
0,261,777,466,-311,False
0,449,150,212,62,False
1,92,550,186,-364,False
1,920,529,377,-152,True
0,990,529,3,-526,True
-1,2,814,-97,-911,False
0,244,706,195,-511,False
0,465,179,776,597,False
0,745,206,616,410,True
0,703,846,617,-229,True
-1,635,46,714,668,True
-1,279,818,93,-725,False
1,514,700,670,-30,False
1,240,212,651,439,False
0,397,246,998,752,False
0,61,383,913,530,False
0,65,231,678,447,False
0,868,691,699,8,True
1,501,531,950,419,False
1,980,29,333,304,True
1,883,342,559,217,True
-1,824,967,775,-192,True
0,644,999,335,-664,True
0,112,514,349,-165,False
-1,454,463,297,-166,True
1,711,147,921,774,True
0,28,628,413,-215,False
0,220,892,124,-768,False
-1,359,780,873,93,False
0,637,416,848,432,True
-1,767,802,685,-117,True
0,152,848,263,-585,False
-1,822,663,151,-512,True
1,822,889,1011,122,True
1,768,459,459,0,True
0,1000,576,625,49,True
0,165,670,562,-108,False
1,390,362,485,123,False
0,863,857,265,-592,True
0,190,701,791,90,False
1,469,557,1028,471,False
1,589,291,352,61,False
-1,250,823,-32,-855,False
0,869,339,79,-260,True
1,870,457,754,297,True
1,201,981,465,-516,False
-1,737,103,746,643,True
-1,262,508,194,-314,False
1,97,564,878,314,False
1,645,441,418,-23,True
1,781,874,896,22,True
0,961,144,207,63,True
1,303,618,392,-226,False
0,353,579,467,-112,False
-1,804,460,612,152,True
1,362,712,492,-220,False
-1,263,496,213,-283,False
-1,120,653,600,-53,False
0,486,511,741,230,False
-1,294,497,468,-29,False
1,158,27,834,807,False
0,461,438,515,77,False
1,711,477,724,247,True
1,164,977,508,-469,False
-1,129,929,121,-808,False
-1,311,979,789,-190,False
0,557,875,571,-304,True
0,875,240,845,605,True
1,870,480,808,328,True
1,423,192,1027,835,False
0,977,811,11,-800,True
-1,50,520,797,277,False
0,15,724,730,6,False
1,499,132,744,612,False
1,17,758,369,-389,False
0,742,427,319,-108,True
1,182,413,275,-138,False
0,669,969,603,-366,True
0,397,147,641,494,False
1,269,415,219,-196,False
1,480,222,1077,855,False
-1,391,207,518,311,False
1,557,758,382,-376,False
-1,187,819,376,-443,False
1,1000,780,102,-678,True
1,730,529,211,-318,True
1,663,490,1014,524,False
0,303,311,46,-265,False
1,137,931,692,-239,False
1,807,308,317,9,True
-1,494,665,172,-493,True
0,689,348,407,59,True
1,191,122,312,190,False
0,168,971,190,-781,False
1,619,644,748,104,False
0,309,530,101,-429,False
1,517,999,657,-342,False
-1,453,972,657,-315,True
0,921,55,386,331,True
0,11,542,917,375,False
0,826,749,153,-596,True
1,52,818,123,-695,False
1,687,603,125,-478,True
-1,774,714,296,-418,True
-1,105,37,40,3,False
0,216,851,867,16,False
-1,491,253,358,105,False
1,316,700,613,-87,False
0,656,202,153,-49,True
0,696,369,551,182,True
1,855,136,128,-8,True
0,303,732,284,-448,False
-1,1000,54,-4,-58,True
0,906,856,362,-494,True
0,968,159,379,220,True
1,205,639,887,248,False
1,954,443,571,128,True
1,473,879,386,-493,False
0,981,968,93,-875,True
0,62,269,194,-75,False
0,615,393,441,48,True
-1,826,297,627,330,True
1,215,596,886,290,False
1,221,674,867,193,False
1,45,244,242,-2,False
-1,858,412,-73,-485,True
-1,141,252,271,19,False
0,935,102,70,-32,True
-1,211,324,720,396,False
1,816,735,829,94,True
1,940,772,796,24,True
0,571,33,93,60,True
0,831,677,863,186,True
0,729,190,1000,810,True
1,155,274,383,109,False
-1,469,605,-87,-692,True
0,685,281,572,291,True
-1,829,650,539,-111,True
0,852,716,778,62,True
1,484,183,698,515,False
1,313,259,365,106,False
0,566,373,473,100,True
-1,774,806,408,-398,True
1,338,75,221,146,False
0,211,436,688,252,False
-1,340,985,69,-916,False
0,939,851,660,-191,True
-1,758,487,-19,-506,True
1,468,964,1076,112,False
0,656,638,516,-122,True
-1,934,231,318,87,True
1,148,160,742,582,False
1,342,617,371,-246,False
0,501,93,202,109,False
1,147,624,1065,441,False
0,374,836,286,-550,False
-1,360,197,26,-171,False
0,94,746,623,-123,False
-1,751,75,727,652,True
0,184,837,329,-508,False
0,486,728,333,-395,False
0,273,496,341,-155,False
1,374,1,682,681,False
1,346,703,555,-148,False
1,480,210,524,314,False
1,618,542,872,330,False
-1,959,396,461,65,True
1,4,712,216,-496,False
1,667,343,520,177,False
-1,321,307,-39,-346,False
1,551,326,601,275,False
-1,73,701,450,-251,False
0,847,690,363,-327,True
-1,837,157,61,-96,True
0,160,750,455,-295,False
0,281,761,117,-644,False
-1,476,619,128,-491,True
0,451,632,22,-610,False
-1,479,153,240,87,True
1,352,588,774,186,False
-1,530,923,80,-843,True
-1,431,875,506,-369,False
-1,120,868,-76,-944,False
1,495,619,347,-272,False
-1,146,760,-46,-806,False
-1,962,404,527,123,True
1,819,415,1012,597,True
1,570,562,775,213,False
1,976,954,441,-513,True
-1,974,75,93,18,True
0,756,102,626,524,True
0,843,711,832,121,True
-1,534,625,365,-260,True
-1,61,529,879,350,False
0,681,530,132,-398,True
-1,866,104,146,42,True
1,839,197,682,485,True
-1,643,846,-27,-873,True
0,167,89,144,55,False
1,959,974,405,-569,True
1,784,243,135,-108,True
-1,13,999,771,-228,False
1,546,554,657,103,False
0,144,980,699,-281,False
0,505,584,252,-332,False
1,222,294,400,106,False
1,722,802,989,187,True
-1,302,299,-71,-370,False
-1,104,913,809,-104,False
1,498,169,301,132,False
1,299,101,987,886,False
0,89,478,882,404,False
1,770,890,1075,185,True
-1,891,448,603,155,True
1,798,769,900,131,True
0,309,18,190,172,False
0,999,627,788,161,True
1,568,935,991,56,False
-1,21,41,827,786,False
-1,95,504,118,-386,False
-1,620,92,291,199,True
-1,776,131,188,57,True
0,136,867,114,-753,False
-1,792,155,416,261,True
-1,1000,124,238,114,True
0,195,217,414,197,False
-1,261,276,408,132,False
-1,983,668,551,-117,True
1,781,777,222,-555,True
0,682,243,316,73,True
1,924,58,938,880,True
1,307,668,423,-245,False
1,467,196,493,297,False
1,847,419,1004,585,True
0,732,611,720,109,True
1,820,354,690,336,True
0,557,418,86,-332,True
1,223,572,341,-231,False
1,139,74,745,671,False
-1,178,316,516,200,False
-1,712,845,236,-609,True
-1,579,539,861,322,True
-1,358,870,687,-183,False
0,762,713,122,-591,True
0,906,436,287,-149,True
-1,193,84,884,800,False
0,931,833,553,-280,True
-1,140,653,-25,-678,False
0,358,420,331,-89,False
0,579,692,374,-318,False
-1,246,272,670,398,False
0,580,402,555,153,True
0,848,548,182,-366,True
-1,205,234,709,475,False
0,907,773,360,-413,True
1,53,679,969,290,False
-1,414,953,714,-239,False
-1,852,209,-1,-210,True
1,153,902,315,-587,False
-1,462,844,63,-781,True
0,860,379,790,411,True
0,870,765,434,-331,True
1,417,927,512,-415,False
0,121,299,708,409,False
0,804,157,667,510,True
0,396,427,404,-23,False
1,852,344,897,553,True
0,589,665,496,-169,False
1,858,902,248,-654,True
0,91,831,185,-646,False
0,659,597,671,74,True
-1,59,262,433,171,False
-1,849,928,241,-687,True
-1,312,531,184,-347,False
1,453,893,1100,207,False
1,562,830,266,-564,False
-1,23,712,460,-252,False
1,783,687,433,-254,True
1,650,565,357,-208,False
1,131,235,169,-66,False
1,525,259,286,27,False
0,987,495,507,12,True
1,910,470,738,268,True
-1,402,188,261,73,False
1,497,78,515,437,False
1,963,496,261,-235,True
0,293,999,960,-39,False
1,468,878,927,49,False
0,269,415,172,-243,False
1,118,504,394,-110,False
1,152,681,666,-15,False
1,252,202,129,-73,False
0,679,739,496,-243,True
1,452,458,734,276,False
0,872,619,303,-316,True
0,111,948,817,-131,False
-1,678,78,59,-19,True
0,718,530,189,-341,True
1,221,117,1045,928,False
1,522,294,874,580,False
0,204,48,473,425,False
1,266,392,1053,661,False
0,85,821,159,-662,False
-1,42,918,418,-500,False
-1,364,832,581,-251,False
-1,118,748,58,-690,False
0,452,523,740,217,False
-1,913,357,83,-274,True
0,81,46,357,311,False
1,574,593,426,-167,False
-1,810,168,276,108,True
1,547,804,282,-522,False
1,943,777,636,-141,True
1,887,370,1015,645,True
0,41,369,792,423,False
-1,191,892,96,-796,False
1,980,643,941,298,True
-1,45,582,244,-338,False
-1,160,892,-32,-924,False
1,695,578,1041,463,True
0,493,931,580,-351,False
-1,969,723,259,-464,True
-1,263,114,7,-107,False
0,241,876,408,-468,False
1,631,76,527,451,True
-1,319,368,761,393,False
-1,926,635,850,215,True
1,79,911,732,-179,False
1,667,625,475,-150,True
1,620,747,608,-139,True
-1,739,469,670,201,True
-1,799,325,497,172,True
1,643,401,658,257,False
-1,272,653,565,-88,False
-1,769,690,282,-408,True
-1,486,361,646,285,True
0,615,666,219,-447,True
0,473,957,72,-885,False
1,852,347,951,604,True
1,958,624,891,267,True
-1,22,986,457,-529,False
1,66,569,393,-176,False
0,560,879,891,12,True
0,152,428,524,96,False
0,186,810,143,-667,False
0,338,965,613,-352,False
0,171,865,32,-833,False
-1,383,970,-94,-1064,False
-1,968,404,433,29,True
1,175,993,535,-458,False
0,427,69,724,655,False
-1,86,706,542,-164,False
1,326,862,1038,176,False
0,296,494,533,39,False
-1,478,503,651,148,True
0,970,991,94,-897,True
1,659,434,455,21,True
0,712,23,283,260,True
-1,170,995,803,-192,False
-1,291,159,77,-82,False
-1,126,149,631,482,False
1,892,552,1007,455,True
-1,162,485,425,-60,False
-1,11,953,502,-451,False
0,866,198,940,742,True
1,562,418,582,164,False
-1,456,807,-33,-840,True
1,306,83,474,391,False
-1,610,631,703,72,True
0,220,210,390,180,False
-1,805,149,811,662,True
0,342,491,735,244,False
1,524,620,394,-226,False
0,423,285,169,-116,False
1,437,181,772,591,False
-1,494,906,454,-452,True
0,876,607,971,364,True
0,237,214,215,1,False
0,536,84,393,309,False
0,678,656,351,-305,True
-1,967,942,586,-356,True
0,267,194,812,618,False
1,10,466,935,469,False
0,759,719,514,-205,True
-1,112,80,-49,-129,False
0,873,166,449,283,True
0,508,723,41,-682,False
-1,119,77,628,551,False
-1,174,424,-78,-502,False
1,211,557,910,353,False
1,818,774,987,213,True
0,212,97,940,843,False
1,159,735,370,-365,False
-1,360,309,368,59,False
-1,851,460,22,-438,True
-1,890,890,859,-31,True
-1,42,588,651,63,False
1,63,646,1051,405,False
-1,800,362,242,-120,True
1,981,848,685,-163,True
0,340,731,809,78,False
1,356,509,957,448,False
1,823,262,455,193,True
1,121,888,1028,140,False
0,703,942,853,-89,True
1,517,840,249,-591,False
0,494,817,186,-631,False
-1,661,30,678,648,True
1,915,924,225,-699,True
1,760,127,855,728,True
-1,172,383,343,-40,False
-1,633,521,362,-159,True
-1,256,928,311,-617,False
-1,206,468,11,-457,False
1,952,149,648,499,True
1,680,213,439,226,True
-1,75,357,593,236,False
1,942,657,413,-244,True
-1,84,12,76,64,False
-1,94,919,556,-363,False
0,417,339,773,434,False
-1,330,768,867,99,False
-1,11,930,852,-78,False
1,481,892,925,33,False
0,174,623,229,-394,False
-1,534,701,759,58,True
-1,108,161,420,259,False
-1,174,532,46,-486,False
0,197,980,393,-587,False
0,737,536,727,191,True
1,976,981,606,-375,True
0,682,631,821,190,True
1,250,91,609,518,False
0,719,637,732,95,True
0,560,81,315,234,True
1,687,751,897,146,False
-1,649,979,525,-454,True
1,53,48,190,142,False
-1,483,626,-42,-668,True
-1,71,695,61,-634,False
1,874,782,606,-176,True
1,893,851,380,-471,True
-1,454,114,429,315,True
0,125,25,382,357,False
-1,591,416,-15,-431,True
0,638,60,250,190,True
1,849,127,187,60,True
0,553,694,355,-339,True
-1,402,665,642,-23,False
1,165,805,759,-46,False
1,57,859,791,-68,False
1,968,104,783,679,True
-1,352,871,-19,-890,False
-1,240,490,-49,-539,False
-1,846,464,533,69,True
0,579,667,910,243,False
0,425,330,580,250,False
0,770,42,962,920,True
1,513,141,808,667,False
-1,923,23,213,190,True
-1,200,13,702,689,False
-1,708,516,866,350,True
0,110,451,721,270,False
-1,661,582,133,-449,True
0,541,509,974,465,False
0,464,588,561,-27,False
-1,978,10,540,530,True
0,91,547,221,-326,False
1,180,142,472,330,False
1,574,19,1061,1042,False
-1,312,906,645,-261,False
-1,129,528,-55,-583,False
1,576,702,1031,329,False
-1,566,507,-90,-597,True
0,317,328,766,438,False
-1,803,276,619,343,True
0,164,664,365,-299,False
-1,117,451,691,240,False
0,100,973,642,-331,False
0,715,30,230,200,True
-1,257,780,153,-627,False
-1,689,43,210,167,True
0,461,148,553,405,False
-1,805,638,878,240,True
-1,383,149,631,482,False
0,268,181,947,766,False
1,683,911,877,-34,True
1,367,552,269,-283,False
1,436,974,300,-674,False
1,228,731,906,175,False
0,467,911,51,-860,False
0,890,642,709,67,True
0,426,69,873,804,False
-1,795,515,570,55,True
0,413,754,137,-617,False
-1,335,990,142,-848,False
-1,556,622,-17,-639,True
0,990,390,85,-305,True
1,635,495,324,-171,True
0,102,195,916,721,False
0,420,322,918,596,False
1,999,934,149,-785,True
0,910,777,754,-23,True
-1,47,141,134,-7,False
-1,347,2,710,708,False
0,570,570,76,-494,True
-1,451,530,679,149,False
1,98,257,445,188,False
1,259,440,595,155,False
1,275,809,336,-473,False
0,21,401,88,-313,False
0,880,373,841,468,True
-1,759,229,555,326,True
1,604,614,313,-301,False
1,11,431,720,289,False
-1,344,769,499,-270,False
0,212,3,335,332,False
1,159,828,350,-478,False
-1,885,191,88,-103,True
0,927,123,676,553,True
0,874,482,413,-69,True
1,601,666,266,-400,False
-1,882,176,715,539,True
1,256,294,977,683,False
0,385,728,698,-30,False
-1,446,224,136,-88,True
1,738,757,305,-452,True
-1,200,336,369,33,False
1,20,161,420,259,False
1,137,524,329,-195,False
0,71,335,462,127,False
1,931,663,405,-258,True
-1,145,873,815,-58,False
1,102,206,770,564,False
-1,809,777,349,-428,True
-1,842,421,130,-291,True
1,892,22,166,144,True
1,115,932,391,-541,False
-1,389,8,805,797,False
-1,106,940,685,-255,False
-1,711,827,140,-687,True
0,849,856,300,-556,True
1,934,741,293,-448,True
-1,65,500,428,-72,False
1,794,598,119,-479,True
0,644,834,391,-443,True
-1,470,984,446,-538,True
0,787,767,512,-255,True
0,880,528,733,205,True
-1,856,555,-37,-592,True
0,509,232,88,-144,False
1,184,776,743,-33,False
1,635,277,647,370,False
0,384,859,791,-68,False
0,246,221,786,565,False
-1,844,141,349,208,True
0,191,116,955,839,False
0,746,860,868,8,True
-1,209,489,19,-470,False
1,635,50,231,181,False
0,862,165,831,666,True
-1,631,907,282,-625,True
0,850,806,94,-712,True
1,225,429,529,100,False
0,346,383,401,18,False
0,431,888,605,-283,False
0,97,811,384,-427,False
0,87,417,71,-346,False
1,180,5,518,513,False
0,256,586,588,2,False
1,291,802,514,-288,False
0,901,960,681,-279,True
1,948,952,868,-84,True
1,548,595,643,48,False
-1,408,463,430,-33,False
0,725,825,898,73,True
-1,602,807,498,-309,True
0,119,538,780,242,False
-1,950,957,516,-441,True
0,734,323,725,402,True
-1,673,985,465,-520,True
-1,802,245,448,203,True
0,834,771,301,-470,True
-1,321,956,365,-591,False
0,98,887,337,-550,False
0,933,470,848,378,True
0,270,767,463,-304,False
1,990,763,710,-53,True
1,750,428,210,-218,True
0,113,440,486,46,False
0,215,276,65,-211,False
0,822,477,249,-228,True
-1,53,105,628,523,False
0,821,581,890,309,True
-1,29,248,582,334,False
-1,588,633,625,-8,True
0,66,172,229,57,False
0,601,286,117,-169,True
0,110,221,526,305,False
-1,341,631,779,148,False
-1,336,517,812,295,False
-1,17,774,-35,-809,False
1,833,456,545,89,True
-1,974,992,119,-873,True
-1,978,704,73,-631,True
0,527,637,625,-12,False
1,44,677,495,-182,False
-1,970,992,274,-718,True
1,724,243,1043,800,True
-1,837,163,816,653,True
1,428,459,1096,637,False
-1,15,15,187,172,False
1,974,929,1026,97,True
0,648,881,798,-83,True
0,759,740,919,179,True
-1,100,752,152,-600,False
0,1,934,493,-441,False
-1,727,584,306,-278,True
0,308,64,1,-63,False
1,156,916,613,-303,False
0,649,584,288,-296,True
-1,828,718,549,-169,True
1,645,684,180,-504,False
-1,568,470,704,234,True
1,986,255,285,30,True
0,707,641,24,-617,True
0,227,238,739,501,False
0,600,387,375,-12,True
0,206,60,779,719,False
-1,788,813,170,-643,True
0,336,884,274,-610,False
0,463,47,240,193,False
0,677,12,222,210,True
0,341,317,625,308,False
-1,46,966,291,-675,False
1,759,568,562,-6,True
0,576,523,266,-257,True
-1,125,909,109,-800,False
-1,737,850,819,-31,True
1,586,808,654,-154,False
-1,158,617,281,-336,False
0,138,328,788,460,False
0,250,566,514,-52,False
-1,690,205,-74,-279,True
1,442,228,491,263,False
-1,63,292,765,473,False
0,384,82,935,853,False
0,701,249,187,-62,True
0,599,229,629,400,True
-1,867,563,-29,-592,True
-1,24,397,241,-156,False
-1,978,105,-87,-192,True
-1,739,702,371,-331,True
1,923,770,1018,248,True
0,931,357,810,453,True
-1,934,803,668,-135,True
1,225,557,340,-217,False
1,667,318,255,-63,True
0,107,644,643,-1,False
-1,731,243,663,420,True
1,482,966,168,-798,False
0,550,172,251,79,False
1,975,520,530,10,True
-1,850,74,166,92,True
1,315,95,1014,919,False
0,211,502,544,42,False
0,484,556,5,-551,False
-1,636,618,690,72,True
0,501,967,174,-793,False
-1,81,361,846,485,False
-1,130,979,387,-592,False
0,350,792,109,-683,False
0,192,533,540,7,False
-1,672,370,748,378,True
0,643,866,225,-641,True
-1,708,146,-32,-178,True
1,123,669,363,-306,False
0,963,345,384,39,True
-1,541,986,528,-458,True
-1,131,871,39,-832,False
-1,48,308,305,-3,False
1,777,133,114,-19,True
1,378,97,592,495,False
1,876,418,1058,640,True
-1,476,827,294,-533,True
-1,225,935,9,-926,False
1,690,213,768,555,True
1,376,987,640,-347,False
0,16,610,957,347,False
0,528,589,801,212,False
1,767,247,364,117,True
-1,650,95,735,640,True
-1,807,55,75,20,True
-1,553,726,155,-571,True
0,633,661,448,-213,True
1,918,400,229,-171,True
0,430,617,610,-7,False
-1,106,651,390,-261,False
0,398,529,113,-416,False
0,360,74,97,23,False
1,104,647,768,121,False
1,894,865,609,-256,True
1,786,773,789,16,True
0,651,671,274,-397,True
0,420,93,530,437,False
-1,34,193,837,644,False
-1,124,438,710,272,False
0,472,974,390,-584,False
1,507,23,745,722,False
-1,617,978,678,-300,True
0,30,776,333,-443,False
1,803,540,595,55,True
0,744,632,835,203,True
-1,918,111,354,243,True
-1,165,572,-51,-623,False
1,733,749,231,-518,True
-1,478,243,752,509,False
1,675,543,1022,479,False
0,540,498,115,-383,False
-1,960,193,605,412,True
-1,170,666,-45,-711,False
0,842,274,841,567,True
0,562,499,910,411,True
0,154,960,797,-163,False
1,7,766,114,-652,False
1,675,703,705,2,True
0,653,38,464,426,True
1,546,454,286,-168,False
1,568,136,649,513,False
-1,698,892,310,-582,True
0,14,409,498,89,False
0,720,521,213,-308,True
1,613,830,340,-490,False
-1,387,132,718,586,False
-1,139,401,643,242,False
1,682,328,816,488,True
-1,933,914,23,-891,True
1,747,285,259,-26,True
-1,603,200,426,226,True
1,41,227,282,55,False
1,627,340,219,-121,True
0,122,713,380,-333,False
-1,794,276,519,243,True
0,332,331,632,301,False
-1,241,574,227,-347,False
1,897,617,846,229,True
-1,937,44,260,216,True
0,658,284,678,394,True
1,228,307,881,574,False
0,817,577,862,285,True
1,165,673,174,-499,False
0,142,976,379,-597,False
0,718,484,1,-483,True
1,799,818,773,-45,True
0,381,298,379,81,False
-1,505,133,866,733,True
-1,46,127,558,431,False
0,765,745,287,-458,True
1,566,328,797,469,False
1,228,249,345,96,False
1,330,74,168,94,False
0,866,505,965,460,True
1,894,969,103,-866,True
1,780,716,448,-268,True
-1,748,575,600,25,True
-1,940,109,879,770,True
1,466,528,670,142,False
1,415,726,155,-571,False
-1,572,811,-87,-898,True
-1,800,868,125,-743,True
0,190,926,622,-304,False
0,828,150,807,657,True
1,167,107,856,749,False
1,923,514,193,-321,True
0,59,791,564,-227,False
0,762,832,408,-424,True
0,47,746,691,-55,False
0,202,961,430,-531,False
1,880,505,1021,516,True
0,518,500,116,-384,False
0,536,500,134,-366,False
0,554,500,152,-348,False
0,572,500,170,-330,False
0,590,500,188,-312,False
0,608,500,209,-291,True
0,626,500,236,-264,True
0,644,500,263,-237,True
0,662,500,290,-210,True
0,680,500,317,-183,True
0,698,500,344,-156,True
0,716,500,371,-129,True
0,734,500,398,-102,True
0,752,500,425,-75,True
0,770,500,452,-48,True
0,788,500,479,-21,True
0,806,500,500,0,True
0,824,500,473,-27,True
0,842,500,488,-12,True
0,860,500,497,-3,True
2,874,502,524,22,True
2,856,520,545,25,True
2,838,538,524,-14,True
2,820,556,527,-29,True
2,802,574,554,-20,True
2,784,592,581,-11,True
2,766,610,608,-2,True
2,748,628,605,-23,True
2,730,646,626,-20,True
2,712,664,653,-11,True
2,694,682,662,-20,True
2,676,700,641,-59,True
2,658,718,668,-50,True
2,640,736,695,-41,True
2,622,754,722,-32,True
2,604,772,749,-23,True
2,586,790,769,-21,False
2,568,808,777,-31,False
2,550,826,775,-51,False
2,532,844,793,-51,False
2,514,862,811,-51,False
2,496,880,829,-51,False
2,478,898,847,-51,False
-1,460,895,865,-30,False
-1,442,886,883,-3,False
-1,424,877,897,20,False
-1,406,868,903,35,False
-1,388,859,905,46,False
-1,370,850,887,37,False
-1,352,841,869,28,False
-1,334,832,851,19,False
-1,316,823,833,10,False
-1,298,814,851,37,False
-1,280,805,833,28,False
-1,262,796,815,19,False
-1,244,787,805,18,False
-1,226,778,787,9,False
-1,208,769,793,24,False
-1,190,760,799,39,False
-1,172,751,789,38,False
-1,154,742,771,29,False
-1,136,733,753,20,False
-1,118,724,735,11,False
-1,100,715,721,6,False
-1,82,706,707,1,False
-1,64,697,705,8,False
-1,46,688,691,3,False
-1,28,679,673,-6,False
-1,10,670,691,21,False
1,494,101,697,596,False
1,476,110,679,569,False
1,458,119,661,542,False
1,440,128,643,515,False
1,422,137,625,488,False
1,404,146,607,461,False
1,386,155,589,434,False
1,368,164,571,407,False
1,350,173,553,380,False
1,332,182,535,353,False
1,314,191,517,326,False
1,296,200,499,299,False
1,278,209,481,272,False
1,260,218,463,245,False
1,242,227,445,218,False
1,224,236,427,191,False
1,206,245,409,164,False
1,188,254,391,137,False
1,170,263,373,110,False
1,152,272,355,83,False
1,134,281,337,56,False
1,116,290,319,29,False
2,110,302,301,-1,False
2,128,320,291,-29,False
2,146,338,297,-41,False
2,164,356,315,-41,False
2,182,374,333,-41,False
2,200,392,351,-41,False
2,218,410,369,-41,False
2,236,428,387,-41,False
2,254,446,405,-41,False
2,272,464,423,-41,False
2,290,482,441,-41,False
2,308,500,459,-41,False
2,326,518,477,-41,False
2,344,536,495,-41,False
2,362,554,513,-41,False
2,380,572,531,-41,False
2,398,590,549,-41,False
2,416,608,567,-41,False
2,434,626,585,-41,False
2,452,644,603,-41,False
2,470,662,621,-41,False
2,488,680,639,-41,False
2,506,698,657,-41,False
2,524,716,675,-41,False
2,542,734,693,-41,False
2,560,752,711,-41,False
2,578,770,729,-41,False
2,596,788,747,-41,False
2,614,806,771,-35,True
2,632,824,798,-26,True
2,650,842,825,-17,True
2,668,860,852,-8,True
2,686,878,879,1,True
2,704,896,906,10,True
-1,722,896,933,37,True
-1,740,887,906,19,True
-1,758,878,879,1,True
-1,776,869,858,-11,True
-1,794,860,843,-17,True
-1,812,851,852,1,True
-1,830,842,879,37,True
-1,848,833,882,49,True
-1,866,824,855,31,True
2,868,827,828,1,True
2,850,845,801,-44,True
2,832,863,828,-35,True
2,814,881,855,-26,True
2,796,899,864,-35,True
-1,778,893,891,-2,True
-1,760,884,876,-8,True
-1,742,875,867,-8,True
-1,724,866,876,10,False
-1,706,857,876,19,False
-1,688,848,874,26,False
-1,670,839,872,33,False
-1,652,830,854,24,False
-1,634,821,856,35,False
-1,616,812,842,30,False
-1,598,803,828,25,False
-1,580,794,818,24,False
-1,562,785,820,35,False
-1,544,776,802,26,False
-1,526,767,784,17,False
-1,508,758,766,8,False
-1,490,749,748,-1,False
-1,472,740,746,6,False
-1,454,731,748,17,False
-1,436,722,750,28,False
-1,418,713,752,39,False
-1,400,704,746,42,False
-1,382,695,732,37,False
-1,364,686,714,28,False
-1,346,677,696,19,False
-1,328,668,678,10,False
-1,310,659,660,1,False
-1,292,650,658,8,False
-1,274,641,640,-1,False
-1,256,632,622,-10,False
-1,238,623,604,-19,False
-1,220,614,622,8,False
-1,202,605,640,35,False
-1,184,596,654,58,False
-1,166,587,636,49,False
-1,148,578,618,40,False
-1,130,569,604,35,False
-1,112,560,594,34,False
-1,94,551,576,25,False
-1,76,542,586,44,False
-1,58,533,568,35,False
-1,40,524,550,26,False
-1,22,515,560,45,False
-1,4,506,542,36,False
-1,488,492,524,32,False
-1,470,483,506,23,False
-1,452,474,488,14,False
-1,434,465,478,13,False
-1,416,456,484,28,False
-1,398,447,494,47,False
-1,380,438,480,42,False
-1,362,429,462,33,False
-1,344,420,444,24,False
-1,326,411,426,15,False
-1,308,402,408,6,False
-1,290,393,390,-3,False
-1,272,384,372,-12,False
-1,254,375,390,15,False
-1,236,366,400,34,False
-1,218,357,398,41,False
-1,200,348,380,32,False
-1,182,339,374,35,False
-1,164,330,356,26,False
-1,146,321,342,21,False
-1,128,312,328,16,False
-1,110,303,310,7,False
-1,116,294,304,10,False
-1,134,285,290,5,False
-1,152,276,272,-4,False
-1,170,267,270,3,False
-1,188,258,252,-6,False
-1,206,249,234,-15,False
-1,224,240,252,12,False
-1,242,231,250,19,False
-1,260,222,232,10,False
-1,278,213,214,1,False
-1,296,204,224,20,False
-1,314,195,206,11,False
-1,332,186,188,2,False
-1,350,177,170,-7,False
-1,368,168,152,-16,False
-1,386,159,170,11,False
-1,404,150,164,14,False
-1,422,141,146,5,False
-1,440,132,140,8,False
-1,458,123,126,3,False
-1,476,114,120,6,False
-1,494,105,138,33,False
1,512,102,120,18,False
1,530,111,102,-9,False
1,548,120,104,-16,False
1,566,129,86,-43,False
1,584,138,88,-50,False
1,602,147,106,-41,False
1,620,156,131,-25,True
1,638,165,158,-7,True
1,656,174,185,11,True
1,674,183,212,29,True
1,692,192,227,35,True
1,710,201,242,41,True
1,728,210,221,11,True
1,746,219,206,-13,True
1,764,228,209,-19,True
1,782,237,236,-1,True
1,800,246,263,17,True
1,818,255,272,17,True
1,836,264,245,-19,True
1,854,273,224,-49,True
1,872,282,251,-31,True
2,862,298,278,-20,True
2,844,316,287,-29,True
2,826,334,296,-38,True
2,808,352,299,-53,True
2,790,370,326,-44,True
2,772,388,353,-35,True
2,754,406,378,-28,False
2,736,424,388,-36,False
2,718,442,398,-44,False
2,700,460,416,-44,False
2,682,478,434,-44,False
2,664,496,452,-44,False
2,646,514,470,-44,False
2,628,532,488,-44,False
2,610,550,506,-44,False
2,592,568,524,-44,False
2,574,586,542,-44,False
2,556,604,560,-44,False
2,538,622,578,-44,False
2,520,640,596,-44,False
2,502,658,614,-44,False
2,484,676,632,-44,False
2,466,694,650,-44,False
2,448,712,668,-44,False
2,430,730,686,-44,False
2,412,748,704,-44,False
2,394,766,722,-44,False
2,376,784,740,-44,False
2,358,802,758,-44,False
2,340,820,776,-44,False
2,322,838,794,-44,False
2,304,856,812,-44,False
2,286,874,814,-60,False
2,268,892,832,-60,False
-1,250,898,850,-48,False
-1,232,889,868,-21,False
-1,214,880,886,6,False
-1,196,871,904,33,False
-1,178,862,886,24,False
-1,160,853,868,15,False
-1,142,844,854,10,False
-1,124,835,856,21,False
-1,106,826,838,12,False
-1,88,817,848,31,False
-1,70,808,830,22,False
-1,52,799,844,45,False
-1,34,790,826,36,False
-1,16,781,808,27,False
-1,500,432,790,358,False
-1,482,423,772,349,False
-1,464,414,754,340,False
-1,446,405,736,331,False
-1,428,396,718,322,False
-1,410,387,700,313,False
-1,392,378,682,304,False
-1,374,369,664,295,False
-1,356,360,646,286,False
-1,338,351,628,277,False
-1,320,342,610,268,False
-1,302,333,592,259,False
-1,284,324,574,250,False
-1,266,315,556,241,False
-1,248,306,538,232,False
-1,230,297,520,223,False
-1,212,288,502,214,False
-1,194,279,480,201,True
-1,176,270,453,183,True
-1,158,261,426,165,True
-1,140,252,399,147,True
-1,122,243,372,129,True
-1,104,234,345,111,True
-1,86,225,318,93,True
-1,68,216,291,75,True
-1,50,207,264,57,True
-1,32,198,237,39,True
-1,14,189,210,21,True
-1,498,609,188,-421,False
-1,480,600,206,-394,False
-1,462,591,224,-367,False
-1,444,582,242,-340,False
-1,426,573,260,-313,False
-1,408,564,278,-286,False
-1,390,555,296,-259,False
-1,372,546,314,-232,False
-1,354,537,332,-205,False
-1,336,528,350,-178,False
-1,318,519,368,-151,False
-1,300,510,386,-124,False
-1,282,501,404,-97,False
-1,264,492,422,-70,False
-1,246,483,440,-43,False
-1,228,474,458,-16,False
-1,210,465,476,11,False
-1,192,456,486,30,False
-1,174,447,480,33,False
-1,156,438,462,24,False
-1,138,429,460,31,False
-1,120,420,450,30,False
1,106,413,436,23,False
1,124,422,422,0,False
1,142,431,404,-27,False
1,160,440,414,-26,False
1,178,449,432,-17,False
1,196,458,442,-16,False
1,214,467,460,-7,False
1,232,476,478,2,False
1,250,485,496,11,False
1,268,494,486,-8,False
1,286,503,488,-15,False
1,304,512,502,-10,False
1,322,521,520,-1,False
1,340,530,538,8,False
1,358,539,556,17,False
1,376,548,574,26,False
1,394,557,592,35,False
1,412,566,598,32,False
1,430,575,596,21,False
1,448,584,590,6,False
1,466,593,596,3,False
1,484,602,602,0,False
1,502,611,600,-11,False
1,520,620,618,-2,False
1,538,629,620,-9,False
1,556,638,634,-4,False
1,574,647,652,5,False
1,592,656,650,-6,False
1,610,665,664,-1,False
1,628,674,666,-8,False
1,646,683,684,1,False
1,664,692,702,10,False
1,682,701,720,19,False
1,700,710,702,-8,False
1,718,719,700,-19,False
1,736,728,690,-38,False
1,754,737,708,-29,False
1,772,746,726,-20,False
1,790,755,744,-11,False
1,808,764,762,-2,False
1,826,773,744,-29,False
1,844,782,762,-20,False
1,862,791,780,-11,False
-2,872,794,798,4,False
-2,854,776,800,24,False
-2,836,758,790,32,False
-2,818,740,772,32,False
-2,800,722,770,48,False
-2,782,704,752,48,False
-2,764,686,734,48,False
-2,746,668,728,60,False
-2,728,650,710,60,False
-2,710,632,692,60,False
-2,692,614,674,60,False
-2,674,596,656,60,False
-2,656,578,638,60,False
-2,638,560,620,60,False
-2,620,542,602,60,False
-2,602,524,584,60,False
-2,584,506,574,68,False
-2,566,488,556,68,False
-2,548,470,538,68,False
-2,530,452,520,68,False
-2,512,434,502,68,False
-2,494,416,484,68,False
-2,476,398,466,68,False
-2,458,380,448,68,False
-2,440,362,430,68,False
-2,422,344,412,68,False
-2,404,326,394,68,False
-2,386,308,376,68,False
-2,368,290,358,68,False
-2,350,272,340,68,False
-2,332,254,322,68,False
-2,314,236,304,68,False
-2,296,218,286,68,False
-2,278,200,268,68,False
-2,260,182,250,68,False
-2,242,164,232,68,False
-2,224,146,214,68,False
-2,206,128,196,68,False
-2,188,110,178,68,False
1,170,101,160,59,False
1,152,110,142,32,False
1,134,119,124,5,False
1,116,128,106,-22,False
0,110,134,92,-42,False
0,128,134,110,-24,False
0,146,134,128,-6,False
0,164,134,110,-24,False
0,182,134,104,-30,False
0,200,134,110,-24,False
0,218,134,128,-6,False
0,236,134,138,4,False
0,254,134,136,2,False
0,272,134,154,20,False
0,290,134,136,2,False
0,308,134,118,-16,False
0,326,134,104,-30,False
0,344,134,122,-12,False
0,362,134,120,-14,False
0,380,134,130,-4,False
0,398,134,134,0,False
0,416,134,128,-6,False
0,434,134,110,-24,False
0,452,134,100,-34,False
0,470,134,106,-28,False
0,488,134,108,-26,False
0,506,134,118,-16,False
0,524,134,114,-20,False
0,542,134,120,-14,False
0,560,134,138,4,False
0,578,134,124,-10,False
0,596,134,142,8,False
0,614,134,160,26,False
0,632,134,158,24,False
0,650,134,144,10,False
0,668,134,146,12,False
0,686,134,152,18,False
0,704,134,134,0,False
0,722,134,152,18,False
0,740,134,150,16,False
0,758,134,136,2,False
0,776,134,150,16,True
0,794,134,129,-5,True
0,812,134,144,10,True
0,830,134,159,25,True
0,848,134,150,16,True
0,866,134,123,-11,True
0,868,134,102,-32,True
0,850,134,129,-5,True
0,832,134,120,-14,True
0,814,134,99,-35,True
0,796,134,126,-8,True
0,778,134,129,-5,True
0,760,134,143,9,False
0,742,134,125,-9,False
0,724,134,143,9,False
0,706,134,141,7,False
0,688,134,131,-3,False
0,670,134,113,-21,False
0,652,134,103,-31,False
0,634,134,121,-13,False
0,616,134,139,5,False
0,598,134,137,3,False
0,580,134,147,13,False
0,562,134,141,7,False
0,544,134,135,1,False
0,526,134,145,11,False
0,508,134,143,9,False
0,490,134,141,7,False
0,472,134,139,5,False
0,454,134,125,-9,False
0,436,134,131,-3,False
0,418,134,129,-5,False
0,400,134,143,9,False
0,382,134,157,23,False
0,364,134,159,25,False
0,346,134,145,11,False
0,328,134,139,5,False
0,310,134,137,3,False
0,292,134,119,-15,False
0,274,134,121,-13,False
0,256,134,119,-15,False
0,238,134,137,3,False
0,220,134,155,21,False
0,202,134,149,15,False
0,184,134,139,5,False
0,166,134,145,11,False
0,148,134,151,17,False
0,130,134,153,19,False
0,112,134,143,9,False
0,94,134,149,15,False
0,76,134,131,-3,False
0,58,134,117,-17,False
0,40,134,135,1,False
0,22,134,149,15,False
0,4,134,151,17,False
1,488,-39,127,166,True
1,470,-30,104,134,False
1,452,-21,86,107,False
1,434,-12,68,80,False
1,416,-3,50,53,False
1,398,6,32,26,False
1,380,15,14,-1,False
1,362,24,8,-16,False
1,344,33,26,-7,False
1,326,42,44,2,False
1,308,51,62,11,False
1,290,60,60,0,False
1,272,69,78,9,False
1,254,78,96,18,False
1,236,87,78,-9,False
1,218,96,96,0,False
1,200,105,106,1,False
1,182,114,124,10,False
1,164,123,130,7,False
1,146,132,128,-4,False
1,128,141,130,-11,False
1,110,150,136,-14,False
1,92,159,126,-33,False
1,74,168,144,-24,False
1,56,177,162,-15,False
1,38,186,156,-30,False
1,20,195,154,-41,False
1,2,204,172,-32,False
1,486,153,162,9,False
1,468,162,144,-18,False
1,450,171,144,-27,False
1,432,180,162,-18,False
1,414,189,168,-21,False
1,396,198,186,-12,False
1,378,207,204,-3,False
1,360,216,222,6,False
1,342,225,204,-21,False
1,324,234,186,-48,False
1,306,243,204,-39,False
1,288,252,222,-30,False
1,270,261,240,-21,False
1,252,270,246,-24,False
1,234,279,244,-35,False
1,216,288,262,-26,False
1,198,297,272,-25,False
1,180,306,290,-16,False
1,162,315,308,-7,False
1,144,324,314,-10,False
1,126,333,320,-13,False
1,108,342,338,-4,False
1,90,351,324,-27,False
1,72,360,342,-18,False
1,54,369,360,-9,False
1,36,378,378,0,False
1,18,387,396,9,False
1,0,396,414,18,False
1,484,188,396,208,False
1,466,197,378,181,False
1,448,206,360,154,False
1,430,215,342,127,False
1,412,224,324,100,False
1,394,233,306,73,False
1,376,242,288,46,False
1,358,251,270,19,False
1,340,260,252,-8,False
1,322,269,242,-27,False
1,304,278,260,-18,False
1,286,287,278,-9,False
1,268,296,284,-12,False
1,250,305,296,-9,False
1,232,314,282,-32,False
1,214,323,300,-23,False
1,196,332,318,-14,False
1,178,341,328,-13,False
1,160,350,346,-4,False
1,142,359,348,-11,False
1,124,368,362,-6,False
1,106,377,380,3,False
1,88,386,386,0,False
1,70,395,388,-7,False
1,52,404,370,-34,False
1,34,413,380,-33,False
1,16,422,386,-36,False
1,500,466,404,-62,False
1,482,475,422,-53,False
1,464,484,440,-44,False
1,446,493,458,-35,False
1,428,502,476,-26,False
1,410,511,494,-17,False
1,392,520,512,-8,False
1,374,529,530,1,False
1,356,538,532,-6,False
1,338,547,542,-5,False
1,320,556,540,-16,False
1,302,565,542,-23,False
1,284,574,560,-14,False
1,266,583,570,-13,False
1,248,592,576,-16,False
1,230,601,594,-7,False
1,212,610,596,-14,False
1,194,619,582,-37,False
1,176,628,592,-36,False
1,158,637,610,-27,False
1,140,646,628,-18,False
1,122,655,646,-9,False
1,104,664,664,0,False
1,86,673,674,1,False
1,68,682,664,-18,False
1,50,691,678,-13,False
1,32,700,696,-4,False
1,14,709,694,-15,False
1,498,345,680,335,False
1,480,354,662,308,False
1,462,363,644,281,False
1,444,372,626,254,False
1,426,381,608,227,False
1,408,390,590,200,False
1,390,399,572,173,False
1,372,408,554,146,False
1,354,417,536,119,False
1,336,426,518,92,False
1,318,435,500,65,False
1,300,444,482,38,False
1,282,453,472,19,False
1,264,462,470,8,False
1,246,471,472,1,False
1,228,480,482,2,False
1,210,489,472,-17,False
1,192,498,458,-40,False
1,174,507,472,-35,False
1,156,516,466,-50,False
1,138,525,484,-41,False
1,120,534,509,-25,True
1,102,543,536,-7,True
1,84,552,557,5,True
1,66,561,554,-7,True
1,48,570,551,-19,True
1,30,579,578,-1,True
1,12,588,587,-1,True
1,496,542,592,50,False
1,478,551,578,27,False
1,460,560,584,24,False
1,442,569,566,-3,False
1,424,578,564,-14,False
1,406,587,582,-5,False
1,388,596,592,-4,False
1,370,605,602,-3,False
1,352,614,600,-14,False
1,334,623,590,-33,False
1,316,632,604,-28,False
1,298,641,614,-27,False
1,280,650,632,-18,False
1,262,659,638,-21,False
1,244,668,634,-34,False
1,226,677,652,-25,False
1,208,686,670,-16,False
1,190,695,688,-7,False
1,172,704,702,-2,False
1,154,713,704,-9,False
1,136,722,722,0,False
1,118,731,704,-27,False
1,100,740,706,-34,False
1,82,749,708,-41,False
1,64,758,726,-32,False
1,46,767,744,-23,False
1,28,776,764,-12,True
1,10,785,773,-12,True
1,494,573,761,188,False
1,476,582,743,161,False
1,458,591,725,134,False
1,440,600,707,107,False
1,422,609,689,80,False
1,404,618,671,53,False
1,386,627,653,26,False
1,368,636,635,-1,False
1,350,645,617,-28,False
1,332,654,633,-21,False
1,314,663,635,-28,False
1,296,672,653,-19,False
1,278,681,655,-26,False
1,260,690,673,-17,False
1,242,699,691,-8,False
1,224,708,709,1,False
1,206,717,730,13,True
1,188,726,739,13,True
1,170,735,724,-11,True
1,152,744,721,-23,True
1,134,753,730,-23,True
1,116,762,739,-23,True
1,110,771,766,-5,True
1,128,780,781,1,True
1,146,789,796,7,True
1,164,798,811,13,True
1,182,807,834,27,False
1,200,816,816,0,False
1,218,825,798,-27,False
1,236,834,784,-50,False
1,254,843,802,-41,False
1,272,852,820,-32,False
1,290,861,838,-23,False
1,308,870,856,-14,False
1,326,879,862,-17,False
1,344,888,864,-24,False
1,362,897,866,-31,False
-1,380,896,864,-32,False
-1,398,887,874,-13,False
-1,416,878,868,-10,False
-1,434,869,862,-7,False
-1,452,860,876,16,False
-1,470,851,886,35,False
-1,488,842,872,30,False
-1,506,833,862,29,False
-1,524,824,860,36,False
-1,542,815,842,27,False
-1,560,806,824,18,False
-1,578,797,806,9,False
-1,596,788,788,0,False
-1,614,779,790,11,False
-1,632,770,804,34,False
-1,650,761,786,25,False
-1,668,752,768,16,False
-1,686,743,750,7,False
-1,704,734,740,6,False
-1,722,725,754,29,False
-1,740,716,740,24,False
-1,758,707,722,15,False
-1,776,698,704,6,False
-1,794,689,686,-3,False
-1,812,680,704,24,False
-1,830,671,694,23,False
-1,848,662,676,14,False
-1,866,653,658,5,False
-1,868,644,660,16,False
-1,850,635,642,7,False
-1,832,626,624,-2,False
-1,814,617,610,-7,False
-1,796,608,624,16,False
-1,778,599,642,43,False
-1,760,590,624,34,False
-1,742,581,606,25,False
-1,724,572,588,16,False
-1,706,563,570,7,False
-1,688,554,552,-2,False
-1,670,545,534,-11,False
-1,652,536,528,-8,False
-1,634,527,546,19,False
-1,616,518,540,22,False
-1,598,509,530,21,False
-1,580,500,512,12,False
-1,562,491,494,3,False
-1,544,482,476,-6,False
-1,526,473,458,-15,False
-1,508,464,456,-8,False
-1,490,455,462,7,False
-1,472,446,460,14,False
-1,454,437,450,13,False
-1,436,428,448,20,False
-1,418,419,446,27,False
-1,400,410,436,26,False
-1,382,401,434,33,False
-1,364,392,416,24,False
-1,346,383,398,15,False
-1,328,374,380,6,False
-1,310,365,370,5,False
-1,292,356,380,24,False
-1,274,347,362,15,False
-1,256,338,344,6,False
-1,238,329,326,-3,False
-1,220,320,344,24,False
-1,202,311,338,27,False
-1,184,302,320,18,False
-1,166,293,326,33,False
-1,148,284,312,28,False
-1,130,275,294,19,False
-1,112,266,276,10,False
2,114,272,258,-14,False
2,132,290,240,-50,False
2,150,308,250,-58,False
2,168,326,268,-58,False
2,186,344,286,-58,False
2,204,362,304,-58,False
2,222,380,322,-58,False
2,240,398,340,-58,False
2,258,416,358,-58,False
2,276,434,376,-58,False
2,294,452,394,-58,False
2,312,470,412,-58,False
2,330,488,430,-58,False
2,348,506,448,-58,False
2,366,524,466,-58,False
2,384,542,484,-58,False
2,402,560,502,-58,False
2,420,578,520,-58,False
2,438,596,538,-58,False
2,456,614,556,-58,False
2,474,632,574,-58,False
2,492,650,592,-58,False
2,510,668,610,-58,False
2,528,686,628,-58,False
2,546,704,646,-58,False
2,564,722,664,-58,False
2,582,740,682,-58,False
2,600,758,700,-58,False
2,618,776,718,-58,False
2,636,794,736,-58,False
2,654,812,754,-58,False
2,672,830,772,-58,False
2,690,848,790,-58,False
2,708,866,808,-58,False
2,726,884,826,-58,False
-1,744,902,838,-64,False
-1,762,893,856,-37,False
-1,780,884,874,-10,False
-1,798,875,892,17,False
-1,816,866,874,8,False
-1,834,857,860,3,False
-1,852,848,850,2,False
-1,870,839,844,5,False
-1,864,830,826,-4,False
-1,846,821,828,7,False
-1,828,812,810,-2,False
-1,810,803,824,21,False
-1,792,794,806,12,False
-1,774,785,792,7,False
-1,756,776,774,-2,False
-1,738,767,760,-7,False
-1,720,758,742,-16,False
-1,702,749,744,-5,False
-1,684,740,726,-14,False
-1,666,731,724,-7,False
-1,648,722,734,12,False
-1,630,713,752,39,False
-1,612,704,754,50,False
-1,594,695,740,45,False
-1,576,686,722,36,False
-1,558,677,704,27,False
-1,540,668,686,18,False
-1,522,659,704,45,False
-1,504,650,698,48,False
-1,486,641,680,39,False
-1,468,632,670,38,False
-1,450,623,652,29,False
-1,432,614,634,20,False
-1,414,605,632,27,False
-1,396,596,626,30,False
-1,378,587,628,41,False
-1,360,578,618,40,False
-1,342,569,600,31,False
-1,324,560,582,22,False
-1,306,551,568,17,False
-1,288,542,574,32,False
-1,270,533,556,23,False
-1,252,524,546,22,False
-1,234,515,528,13,False
-1,216,506,510,4,False
-1,198,497,504,7,False
-1,180,488,506,18,False
-1,162,479,496,17,False
-1,144,470,478,8,False
-1,126,461,460,-1,False
-1,108,452,442,-10,False
0,118,450,444,-6,False
0,136,450,462,12,False
0,154,450,444,-6,False
0,172,450,442,-8,False
0,190,450,456,6,False
0,208,450,462,12,False
0,226,450,464,14,False
0,244,450,462,12,False
0,262,450,448,-2,False
0,280,450,442,-8,False
0,298,450,452,2,False
0,316,450,446,-4,False
0,334,450,444,-6,False
0,352,450,426,-24,False
0,370,450,424,-26,False
0,388,450,442,-8,False
0,406,450,460,10,False
0,424,450,454,4,False
0,442,450,436,-14,False
0,460,450,426,-24,False
0,478,450,436,-14,False
0,496,450,454,4,False
0,514,450,456,6,False
0,532,450,470,20,False
0,550,450,476,26,False
0,568,450,458,8,False
0,586,450,440,-10,False
0,604,450,446,-4,False
0,622,450,444,-6,False
0,640,450,430,-20,False
0,658,450,444,-6,False
0,676,450,434,-16,False
0,694,450,452,2,False
0,712,450,462,12,False
0,730,450,444,-6,False
0,748,450,427,-23,True
0,766,450,442,-8,True
0,784,450,469,19,True
0,802,450,472,22,True
0,820,450,445,-5,True
0,838,450,436,-14,True
0,856,450,451,1,True
0,874,450,466,16,True
1,860,458,469,11,True
1,842,467,442,-25,False
1,824,476,460,-16,False
1,806,485,478,-7,False
1,788,494,496,2,False
1,770,503,494,-9,False
1,752,512,480,-32,False
1,734,521,490,-31,False
1,716,530,508,-22,False
1,698,539,526,-13,False
1,680,548,544,-4,False
1,662,557,562,5,False
1,644,566,572,6,False
1,626,575,554,-21,False
1,608,584,572,-12,False
1,590,593,590,-3,False
1,572,602,608,6,False
1,554,611,610,-1,False
1,536,620,628,8,False
1,518,629,638,9,False
1,500,638,648,10,False
1,482,647,646,-1,False
1,464,656,656,0,False
1,446,665,654,-11,False
1,428,674,672,-2,False
1,410,683,674,-9,False
1,392,692,660,-32,False
1,374,701,678,-23,False
1,356,710,696,-14,False
1,338,719,698,-21,False
1,320,728,680,-48,False
1,302,737,698,-39,False
1,284,746,716,-30,False
1,266,755,734,-21,False
1,248,764,752,-12,False
1,230,773,758,-15,False
1,212,782,740,-42,False
1,194,791,758,-33,False
1,176,800,776,-24,False
1,158,809,786,-23,False
1,140,818,789,-29,True
1,122,827,804,-23,True
2,104,836,813,-23,True
2,122,854,828,-26,True
2,140,872,855,-17,True
2,158,890,858,-32,True
-1,176,899,885,-14,True
-1,194,890,912,22,True
-1,212,881,885,4,True
-1,230,872,858,-14,True
-1,248,863,885,22,True
-1,266,854,876,22,True
-1,284,845,873,28,True
-1,302,836,852,16,True
-1,320,827,831,4,True
-1,338,818,828,10,False
-1,356,809,814,5,False
-1,374,800,804,4,False
-1,392,791,802,11,False
-1,410,782,788,6,False
-1,428,773,806,33,False
-1,446,764,788,24,False
-1,464,755,770,15,False
-1,482,746,752,6,False
-1,500,737,734,-3,False
-1,518,728,728,0,False
-1,536,719,726,7,False
-1,554,710,724,14,False
-1,572,701,706,5,False
-1,590,692,688,-4,False
-1,608,683,690,7,False
-1,626,674,708,34,False
-1,644,665,698,33,False
-1,662,656,690,34,False
-1,680,647,682,35,False
-1,698,638,664,26,False
-1,716,629,646,17,False
-1,734,620,644,24,False
-1,752,611,630,19,False
-1,770,602,612,10,False
-1,788,593,594,1,False
-1,806,584,600,16,False
-1,824,575,614,39,False
-1,842,566,596,30,False
-1,860,557,578,21,False
0,874,549,560,11,False
0,856,549,542,-7,False
0,838,549,556,7,False
0,820,549,562,13,False
0,802,549,560,11,False
0,784,549,570,21,False
0,766,549,552,3,False
0,748,549,538,-11,False
0,730,549,552,3,False
0,712,549,546,-3,False
0,694,549,556,7,False
0,676,549,562,13,False
0,658,549,564,15,False
0,640,549,546,-3,False
0,622,549,532,-17,False
0,604,549,542,-7,False
0,586,549,548,-1,False
0,568,549,562,13,False
0,550,549,580,31,False
0,532,549,598,49,False
0,514,549,580,31,False
0,496,549,562,13,False
0,478,549,552,3,False
0,460,549,534,-15,False
0,442,549,534,-15,False
0,424,549,552,3,False
0,406,549,562,13,False
0,388,549,544,-5,False
0,370,549,542,-7,False
0,352,549,536,-13,False
0,334,549,534,-15,False
0,316,549,532,-17,False
0,298,549,550,1,False
0,280,549,538,-11,False
0,262,549,536,-13,False
0,244,549,542,-7,False
0,226,549,544,-5,False
0,208,549,534,-15,False
0,190,549,528,-21,False
0,172,549,522,-27,False
0,154,549,540,-9,False
0,136,549,558,9,False
0,118,549,560,11,False
0,108,549,566,17,False
0,126,549,548,-1,False
0,144,549,542,-7,False
0,162,549,546,-3,False
0,180,549,564,15,False
0,198,549,570,21,False
0,216,549,556,7,False
0,234,549,574,25,False
0,252,549,560,11,False
0,270,549,562,13,False
0,288,549,558,9,False
0,306,549,552,3,False
0,324,549,558,9,False
0,342,549,556,7,False
0,360,549,546,-3,False
0,378,549,544,-5,False
0,396,549,546,-3,False
0,414,549,564,15,False
0,432,549,554,5,False
0,450,549,558,9,False
0,468,549,556,7,False
0,486,549,538,-11,False
0,504,549,520,-29,False
0,522,549,526,-23,False
0,540,549,544,-5,False
0,558,549,546,-3,False
0,576,549,532,-17,False
0,594,549,550,1,False
0,612,549,568,19,False
0,630,549,558,9,False
0,648,549,544,-5,False
0,666,549,550,1,False
0,684,549,556,7,False
0,702,549,542,-7,False
0,720,549,544,-5,False
0,738,549,562,13,False
0,756,549,580,31,False
0,774,549,562,13,False
0,792,549,548,-1,False
0,810,549,542,-7,False
0,828,549,544,-5,False
0,846,549,544,-5,False
0,864,549,538,-11,False
0,870,549,532,-17,False
0,852,549,550,1,False
0,834,549,544,-5,False
0,816,549,542,-7,False
0,798,549,548,-1,False
0,780,549,530,-19,False
0,762,549,516,-33,False
0,744,549,534,-15,False
0,726,549,552,3,False
0,708,549,542,-7,False
0,690,549,544,-5,False
0,672,549,558,9,False
0,654,549,544,-5,False
0,636,549,550,1,False
0,618,549,552,3,False
0,600,549,558,9,False
0,582,549,556,7,False
0,564,549,544,-5,False
0,546,549,554,5,False
0,528,549,556,7,False
0,510,549,554,5,False
0,492,549,564,15,False
0,474,549,546,-3,False
0,456,549,548,-1,False
0,438,549,550,1,False
0,420,549,544,-5,False
0,402,549,544,-5,False
0,384,549,562,13,False
0,366,549,556,7,False
0,348,549,546,-3,False
0,330,549,548,-1,False
0,312,549,554,5,False
0,294,549,544,-5,False
0,276,549,550,1,False
0,258,549,542,-7,False
0,240,549,540,-9,False
0,222,549,542,-7,False
0,204,549,552,3,False
0,186,549,546,-3,False
0,168,549,548,-1,False
0,150,549,554,5,False
0,132,549,542,-7,False
0,114,549,532,-17,False
2,112,557,546,-11,False
2,130,575,552,-23,False
2,148,593,554,-39,False
2,166,611,572,-39,False
2,184,629,590,-39,False
2,202,647,608,-39,False
2,220,665,626,-39,False
2,238,683,644,-39,False
2,256,701,662,-39,False
2,274,719,680,-39,False
2,292,737,698,-39,False
2,310,755,716,-39,False
2,328,773,734,-39,False
2,346,791,752,-39,False
2,364,809,770,-39,False
2,382,827,788,-39,False
2,400,845,806,-39,False
2,418,863,824,-39,False
2,436,881,842,-39,False
2,454,899,860,-39,False
-1,472,893,878,-15,False
-1,490,884,880,-4,False
-1,508,875,870,-5,False
-1,526,866,860,-6,False
-1,544,857,846,-11,False
-1,562,848,828,-20,False
-1,580,839,810,-29,False
-1,598,830,812,-18,False
-1,616,821,810,-11,False
-1,634,812,808,-4,False
-1,652,803,826,23,False
-1,670,794,812,18,False
-1,688,785,794,9,False
-1,706,776,784,8,False
-1,724,767,782,15,False
-1,742,758,792,34,False
-1,760,749,798,49,False
-1,778,740,780,40,False
-1,796,731,762,31,False
-1,814,722,744,22,False
-1,832,713,726,13,False
-1,850,704,708,4,False
-1,868,695,690,-5,False
2,866,701,672,-29,False
2,848,719,674,-45,False
2,830,737,688,-49,False
2,812,755,706,-49,False
2,794,773,724,-49,False
2,776,791,742,-49,False
2,758,809,760,-49,False
2,740,827,778,-49,False
2,722,845,796,-49,False
2,704,863,814,-49,False
2,686,881,832,-49,False
2,668,899,850,-49,False
-1,650,893,868,-25,False
-1,632,884,886,2,False
-1,614,875,886,11,False
-1,596,866,872,6,False
-1,578,857,862,5,False
-1,560,848,868,20,False
-1,542,839,886,47,False
-1,524,830,868,38,False
-1,506,821,850,29,False
-1,488,812,832,20,False
-1,470,803,814,11,False
-1,452,794,796,2,False
-1,434,785,778,-7,False
-1,416,776,764,-12,False
-1,398,767,770,3,False
-1,380,758,776,18,False
-1,362,749,770,21,False
-1,344,740,760,20,False
-1,326,731,758,27,False
-1,308,722,764,42,False
-1,290,713,782,69,False
-1,272,704,764,60,False
-1,254,695,746,51,False
-1,236,686,728,42,False
-1,218,677,710,33,False
-1,200,668,708,40,False
-1,182,659,690,31,False
-1,164,650,680,30,False
-1,146,641,670,29,False
-1,128,632,688,56,False
-1,110,623,694,71,False
-2,116,608,676,68,False
-2,134,590,658,68,False
-2,152,572,640,68,False
-2,170,554,622,68,False
-2,188,536,604,68,False
-2,206,518,586,68,False
-2,224,500,568,68,False
-2,242,482,550,68,False
-2,260,464,532,68,False
-2,278,446,514,68,False
-2,296,428,496,68,False
-2,314,410,478,68,False
-2,332,392,460,68,False
-2,350,374,442,68,False
-2,368,356,424,68,False
-2,386,338,406,68,False
-2,404,320,388,68,False
-2,422,302,370,68,False
-2,440,284,352,68,False
-2,458,266,334,68,False
-2,476,248,316,68,False
-2,494,230,298,68,False
-2,512,212,280,68,False
-2,530,194,262,68,False
-2,548,176,244,68,False
-2,566,158,226,68,False
-2,584,140,208,68,False
-2,602,122,190,68,False
-2,620,104,172,68,False
1,638,104,154,50,False
1,656,113,136,23,False
1,674,122,130,8,False
1,692,131,124,-7,False
1,710,140,130,-10,False
1,728,149,134,-15,False
1,746,158,140,-18,False
1,764,167,158,-9,False
1,782,176,174,-2,False
1,800,185,192,7,False
1,818,194,210,16,False
1,836,203,228,25,False
1,854,212,222,10,False
1,872,221,208,-13,False
-2,862,209,210,1,False
-2,844,191,192,1,False
-2,826,173,174,1,False
-2,808,155,156,1,False
-2,790,137,138,1,False
-2,772,119,132,13,False
-2,754,101,138,37,False
1,736,107,120,13,False
1,718,116,126,10,False
1,700,125,144,19,False
1,682,134,138,4,False
1,664,143,124,-19,False
1,646,152,130,-22,False
1,628,161,148,-13,False
1,610,170,166,-4,False
1,592,179,180,1,False
1,574,188,190,2,False
1,556,197,188,-9,False
1,538,206,190,-16,False
1,520,215,204,-11,False
1,502,224,218,-6,False
1,484,233,236,3,False
1,466,242,238,-4,False
1,448,251,256,5,False
1,430,260,254,-6,False
1,412,269,252,-17,False
1,394,278,254,-24,False
1,376,287,248,-39,False
1,358,296,266,-30,False
1,340,305,276,-29,False
1,322,314,292,-22,False
1,304,323,310,-13,False
1,286,332,308,-24,False
1,268,341,310,-31,False
1,250,350,308,-42,False
1,232,359,326,-33,False
1,214,368,344,-24,False
1,196,377,362,-15,False
1,178,386,380,-6,False
1,160,395,386,-9,False
1,142,404,392,-12,False
1,124,413,390,-23,False
1,106,422,408,-14,False
0,120,423,414,-9,False
0,138,423,428,5,False
0,156,423,442,19,False
0,174,423,444,21,False
0,192,423,434,11,False
0,210,423,420,-3,False
0,228,423,422,-1,False
0,246,423,432,9,False
0,264,423,450,27,False
0,282,423,432,9,False
0,300,423,446,23,False
0,318,423,428,5,False
0,336,423,410,-13,False
0,354,423,406,-17,False
0,372,423,416,-7,False
0,390,423,418,-5,False
0,408,423,412,-11,False
0,426,423,406,-17,False
0,444,423,416,-7,False
0,462,423,434,11,False
0,480,423,436,13,False
0,498,423,442,19,False
0,516,423,424,1,False
0,534,423,406,-17,False
0,552,423,408,-15,False
0,570,423,426,3,False
0,588,423,444,21,False
0,606,423,462,39,False
0,624,423,444,21,False
0,642,423,438,15,False
0,660,423,436,13,False
0,678,423,430,7,False
0,696,423,444,21,False
0,714,423,426,3,False
0,732,423,432,9,False
0,750,423,426,3,False
0,768,423,412,-11,False
0,786,423,430,7,False
0,804,423,440,17,False
0,822,423,422,-1,False
0,840,423,443,20,True
0,858,423,440,17,True
1,876,423,413,-10,True
1,858,432,398,-34,True
1,840,441,407,-34,True
1,822,450,429,-21,False
1,804,459,439,-20,False
1,786,468,437,-31,False
1,768,477,455,-22,False
1,750,486,473,-13,False
1,732,495,491,-4,False
1,714,504,509,5,False
1,696,513,527,14,False
1,678,522,541,19,False
1,660,531,543,12,False
1,642,540,557,17,False
1,624,549,539,-10,False
1,606,558,545,-13,False
1,588,567,549,-18,False
1,570,576,567,-9,False
1,552,585,585,0,False
1,534,594,603,9,False
1,516,603,605,2,False
1,498,612,611,-1,False
1,480,621,625,4,False
1,462,630,627,-3,False
1,444,639,629,-10,False
1,426,648,631,-17,False
1,408,657,641,-16,False
1,390,666,659,-7,False
1,372,675,677,2,False
1,354,684,695,11,False
1,336,693,677,-16,False
1,318,702,683,-19,False
1,300,711,701,-10,False
1,282,720,719,-1,False
1,264,729,737,8,False
1,246,738,739,1,False
1,228,747,757,10,False
1,210,756,763,7,False
1,192,765,770,5,True
1,174,774,773,-1,True
1,156,783,794,11,True
1,138,792,821,29,True
1,120,801,824,23,True
2,107,811,821,10,True
2,134,829,818,-11,True
2,161,847,845,-2,True
2,188,865,842,-23,True
2,215,883,827,-56,True
-1,242,901,854,-47,True
-1,269,892,881,-11,True
-1,296,883,872,-11,True
-1,323,874,893,19,True
-1,350,865,890,25,True
-1,377,856,870,14,False
-1,404,847,868,21,False
-1,431,838,878,40,False
-1,458,829,860,31,False
-1,485,820,842,22,False
-1,512,811,824,13,False
-1,539,802,806,4,False
-1,566,793,796,3,False
-1,593,784,790,6,False
-1,620,775,772,-3,False
-1,647,766,758,-8,False
-1,674,757,740,-17,False
-1,701,748,734,-14,False
-1,728,739,732,-7,False
-1,755,730,734,4,False
-1,782,721,732,11,False
-1,809,712,714,2,False
-1,836,703,704,1,False
-1,863,694,694,0,False
-2,866,681,680,-1,False
-2,839,663,674,11,False
-2,812,645,656,11,False
-2,785,627,638,11,False
-2,758,609,620,11,False
-2,731,591,602,11,False
-2,704,573,596,23,False
-2,677,555,578,23,False
-2,650,537,560,23,False
-2,623,519,542,23,False
-2,596,501,524,23,False
-2,569,483,506,23,False
-2,542,465,504,39,False
-2,515,447,486,39,False
-2,488,429,468,39,False
-2,461,411,450,39,False
-2,434,393,432,39,False
-2,407,375,414,39,False
-2,380,357,396,39,False
-2,353,339,378,39,False
-2,326,321,360,39,False
-2,299,303,342,39,False
-2,272,285,328,43,False
-2,245,267,310,43,False
-2,218,249,292,43,False
-2,191,231,274,43,False
-2,164,213,272,59,False
-2,137,195,254,59,False
-2,110,177,236,59,False
-2,83,159,218,59,False
-2,56,141,200,59,False
-2,29,123,182,59,False
-2,2,105,164,59,False
-2,476,370,178,-192,False
-2,449,352,196,-156,False
-2,422,334,214,-120,False
-2,395,316,232,-84,False
-2,368,298,250,-48,False
-2,341,280,268,-12,False
-2,314,262,286,24,False
-2,287,244,268,24,False
-2,260,226,250,24,False
-2,233,208,232,24,False
-2,206,190,214,24,False
-2,179,172,196,24,False
-2,152,154,178,24,False
-2,125,136,160,24,False
-2,98,118,146,28,False
-2,71,100,132,32,False
1,44,106,138,32,False
1,17,115,128,13,False
1,491,157,122,-35,False
1,464,166,140,-26,False
1,437,175,158,-17,False
1,410,184,176,-8,False
1,383,193,194,1,False
1,356,202,196,-6,False
1,329,211,194,-17,False
1,302,220,208,-12,False
1,275,229,210,-19,False
1,248,238,192,-46,False
1,221,247,194,-53,False
1,194,256,212,-44,False
1,167,265,230,-35,False
1,140,274,248,-26,False
1,113,283,266,-17,False
1,122,292,276,-16,False
1,149,301,290,-11,False
1,176,310,308,-2,False
1,203,319,306,-13,False
1,230,328,320,-8,False
1,257,337,314,-23,False
1,284,346,332,-14,False
1,311,355,338,-17,False
1,338,364,336,-28,False
1,365,373,354,-19,False
1,392,382,356,-26,False
1,419,391,366,-25,False
1,446,400,380,-20,False
1,473,409,382,-27,False
1,500,418,396,-22,False
1,527,427,414,-13,False
1,554,436,432,-4,False
1,581,445,446,1,False
1,608,454,444,-10,False
1,635,463,462,-1,False
1,662,472,464,-8,False
1,689,481,482,1,False
1,716,490,484,-6,False
1,743,499,494,-5,False
1,770,508,512,4,False
1,797,517,530,13,False
1,824,526,540,14,False
1,851,535,534,-1,False
-2,878,544,548,4,False
-2,851,526,554,28,False
-2,824,508,536,28,False
-2,797,490,518,28,False
-2,770,472,500,28,False
-2,743,454,494,40,False
-2,716,436,476,40,False
-2,689,418,458,40,False
-2,662,400,440,40,False
-2,635,382,422,40,False
-2,608,364,404,40,False
-2,581,346,386,40,False
-2,554,328,368,40,False
-2,527,310,350,40,False
-2,500,292,344,52,False
-2,473,274,326,52,False
-2,446,256,308,52,False
-2,419,238,290,52,False
-2,392,220,272,52,False
-2,365,202,254,52,False
-2,338,184,236,52,False
-2,311,166,232,66,False
-2,284,148,214,66,False
-2,257,130,196,66,False
-2,230,112,178,66,False
1,203,100,160,60,False
1,176,109,142,33,False
1,149,118,124,6,False
1,122,127,126,-1,False
1,95,136,132,-4,False
1,68,145,138,-7,False
1,41,154,148,-6,False
1,14,163,130,-33,False
1,488,312,132,-180,False
1,461,321,150,-171,False
1,434,330,168,-162,False
1,407,339,186,-153,False
1,380,348,204,-144,False
1,353,357,222,-135,False
1,326,366,240,-126,False
1,299,375,258,-117,False
1,272,384,276,-108,False
1,245,393,294,-99,False
1,218,402,312,-90,False
1,191,411,330,-81,False
1,164,420,348,-72,False
1,137,429,366,-63,False
1,110,438,384,-54,False
1,83,447,402,-45,False
1,56,456,420,-36,False
1,29,465,438,-27,False
1,2,474,456,-18,False
1,476,234,442,208,False
1,449,243,424,181,False
1,422,252,406,154,False
1,395,261,388,127,False
1,368,270,370,100,False
1,341,279,352,73,False
1,314,288,334,46,False
1,287,297,316,19,False
1,260,306,298,-8,False
1,233,315,312,-3,False
1,206,324,326,2,False
1,179,333,316,-17,False
1,152,342,334,-8,False
1,125,351,348,-3,False
1,98,360,366,6,False
1,71,369,384,15,False
1,44,378,392,14,False
1,17,387,374,-13,False
1,491,517,396,-121,False
1,464,526,414,-112,False
1,437,535,432,-103,False
1,410,544,450,-94,False
1,383,553,468,-85,False
1,356,562,486,-76,False
1,329,571,504,-67,False
1,302,580,522,-58,False
1,275,589,540,-49,False
1,248,598,558,-40,False
1,221,607,576,-31,False
1,194,616,594,-22,False
1,167,625,612,-13,False
1,140,634,630,-4,False
1,113,643,648,5,False
1,86,652,662,10,False
1,59,661,680,19,False
1,32,670,694,24,False
1,5,679,676,-3,False
1,479,283,658,375,False
1,452,292,640,348,False
1,425,301,622,321,False
1,398,310,604,294,False
1,371,319,586,267,False
1,344,328,568,240,False
1,317,337,550,213,False
1,290,346,532,186,False
1,263,355,514,159,False
1,236,364,496,132,False
1,209,373,478,105,False
1,182,382,460,78,False
1,155,391,442,51,False
1,128,400,424,24,False
-2,107,406,414,8,False
-2,134,388,400,12,False
-2,161,370,394,24,False
-2,188,352,376,24,False
-2,215,334,358,24,False
-2,242,316,340,24,False
-2,269,298,326,28,False
-2,296,280,308,28,False
-2,323,262,290,28,False
-2,350,244,272,28,False
-2,377,226,254,28,False
-2,404,208,236,28,False
-2,431,190,218,28,False
-2,458,172,200,28,False
-2,485,154,190,36,False
-2,512,136,172,36,False
-2,539,118,154,36,False
-2,566,100,136,36,False
1,593,106,134,28,False
1,620,115,124,9,False
1,647,124,142,18,False
1,674,133,132,-1,False
1,701,142,134,-8,False
1,728,151,140,-11,False
1,755,160,158,-2,False
1,782,169,152,-17,False
1,809,178,154,-24,False
1,836,187,148,-39,False
1,863,196,150,-46,False
-2,866,193,168,-25,False
-2,839,175,170,-5,False
-2,812,157,160,3,False
-2,785,139,154,15,False
-2,758,121,140,19,False
-2,731,103,122,19,False
1,704,106,116,10,False
1,677,115,110,-5,False
1,650,124,120,-4,False
1,623,133,114,-19,False
1,596,142,132,-10,False
1,569,151,134,-17,False
1,542,160,132,-28,False
1,515,169,138,-31,False
1,488,178,156,-22,False
1,461,187,166,-21,False
1,434,196,184,-12,False
1,407,205,198,-7,False
1,380,214,212,-2,False
1,353,223,206,-17,False
1,326,232,224,-8,False
1,299,241,242,1,False
1,272,250,236,-14,False
1,245,259,254,-5,False
1,218,268,268,0,False
1,191,277,282,5,False
1,164,286,296,10,False
1,137,295,302,7,False
1,110,304,288,-16,False
-1,125,299,294,-5,False
-1,152,290,296,6,False
-1,179,281,302,21,False
-1,206,272,296,24,False
-1,233,263,278,15,False
-1,260,254,280,26,False
-1,287,245,262,17,False
-1,314,236,248,12,False
-1,341,227,246,19,False
-1,368,218,232,14,False
-1,395,209,214,5,False
-1,422,200,204,4,False
-1,449,191,198,7,False
-1,476,182,184,2,False
-1,503,173,174,1,False
-1,530,164,172,8,False
-1,557,155,170,15,False
-1,584,146,152,6,False
-1,611,137,134,-3,False
-1,638,128,136,8,False
-1,665,119,118,-1,False
-1,692,110,104,-6,False
-1,719,101,94,-7,False
1,746,106,76,-30,False
1,773,115,70,-45,False
1,800,124,88,-36,False
1,827,133,106,-27,False
1,854,142,124,-18,False
0,875,150,150,0,True
0,848,150,153,3,False
0,821,150,139,-11,False
0,794,150,137,-13,False
0,767,150,135,-15,False
0,740,150,149,-1,False
0,713,150,147,-3,False
0,686,150,161,11,False
0,659,150,143,-7,False
0,632,150,153,3,False
0,605,150,143,-7,False
0,578,150,145,-5,False
0,551,150,151,1,False
0,524,150,153,3,False
0,497,150,147,-3,False
0,470,150,149,-1,False
0,443,150,167,17,False
0,416,150,173,23,False
0,389,150,155,5,False
0,362,150,141,-9,False
0,335,150,143,-7,False
0,308,150,129,-21,False
0,281,150,135,-15,False
0,254,150,125,-25,False
0,227,150,143,-7,False
0,200,150,129,-21,False
0,173,150,135,-15,False
0,146,150,137,-13,False
0,119,150,147,-3,False
0,92,150,149,-1,False
0,65,150,167,17,False
0,38,150,173,23,False
0,11,150,155,5,False
0,485,202,157,-45,False
0,458,202,175,-27,False
0,431,202,193,-9,False
0,404,202,211,9,False
0,377,202,213,11,False
0,350,202,211,9,False
0,323,202,219,17,False
0,296,202,233,31,False
0,269,202,215,13,False
0,242,202,197,-5,False
0,215,202,179,-23,False
0,188,202,161,-41,False
0,161,202,171,-31,False
0,134,202,189,-13,False
0,107,202,203,1,False
0,128,202,213,11,False
0,155,202,231,29,False
0,182,202,213,11,False
0,209,202,199,-3,False
0,236,202,205,3,False
0,263,202,207,5,False
0,290,202,189,-13,False
0,317,202,201,-1,False
0,344,202,195,-7,False
0,371,202,193,-9,False
0,398,202,187,-15,False
0,425,202,205,3,False
0,452,202,207,5,False
0,479,202,193,-9,False
0,506,202,207,5,False
0,533,202,225,23,False
0,560,202,219,17,False
0,587,202,201,-1,False
0,614,202,187,-15,False
0,641,202,202,0,True
0,668,202,223,21,True
0,695,202,196,-6,True
0,722,202,205,3,True
0,749,202,226,24,True
0,776,202,211,9,True
0,803,202,223,21,True
0,830,202,202,0,True
0,857,202,181,-21,True
-2,872,198,208,10,True
-2,845,180,205,25,True
-2,818,162,178,16,True
-2,791,144,157,13,True
-2,764,126,130,4,True
-2,737,108,103,-5,True
1,710,102,100,-2,True
1,683,111,103,-8,True
1,656,120,124,4,True
1,629,129,133,4,True
1,602,138,128,-10,False
1,575,147,142,-5,False
1,548,156,140,-16,False
1,521,165,158,-7,False
1,494,174,172,-2,False
1,467,183,186,3,False
1,440,192,188,-4,False
1,413,201,198,-3,False
1,386,210,204,-6,False
1,359,219,206,-13,False
1,332,228,224,-4,False
1,305,237,234,-3,False
1,278,246,244,-2,False
1,251,255,258,3,False
1,224,264,260,-4,False
1,197,273,262,-11,False
1,170,282,260,-22,False
1,143,291,274,-17,False
1,116,300,288,-12,False
2,119,314,302,-12,False
2,146,332,320,-12,False
2,173,350,334,-16,False
2,200,368,352,-16,False
2,227,386,370,-16,False
2,254,404,380,-24,False
2,281,422,398,-24,False
2,308,440,416,-24,False
2,335,458,430,-28,False
2,362,476,448,-28,False
2,389,494,466,-28,False
2,416,512,484,-28,False
2,443,530,502,-28,False
2,470,548,520,-28,False
2,497,566,538,-28,False
2,524,584,556,-28,False
2,551,602,574,-28,False
2,578,620,580,-40,False
2,605,638,598,-40,False
2,632,656,616,-40,False
2,659,674,634,-40,False
2,686,692,652,-40,False
2,713,710,670,-40,False
2,740,728,688,-40,False
2,767,746,706,-40,False
2,794,764,724,-40,False
2,821,782,742,-40,False
2,848,800,760,-40,False
2,875,818,778,-40,False
-2,854,804,796,-8,False
-2,827,786,786,0,False
-2,800,768,776,8,False
-2,773,750,762,12,False
-2,746,732,752,20,False
-2,719,714,734,20,False
-2,692,696,740,44,False
-2,665,678,722,44,False
-2,638,660,704,44,False
-2,611,642,686,44,False
-2,584,624,668,44,False
-2,557,606,650,44,False
-2,530,588,632,44,False
-2,503,570,614,44,False
-2,476,552,596,44,False
-2,449,534,578,44,False
-2,422,516,560,44,False
-2,395,498,560,62,False
-2,368,480,542,62,False
-2,341,462,524,62,False
-2,314,444,506,62,False
-2,287,426,488,62,False
-2,260,408,470,62,False
-2,233,390,452,62,False
-2,206,372,434,62,False
-2,179,354,416,62,False
-2,152,336,398,62,False
-2,125,318,380,62,False
-2,98,300,362,62,False
-2,71,282,344,62,False
-2,44,264,326,62,False
-2,17,246,308,62,False
-2,491,320,302,-18,False
-2,464,302,308,6,False
-2,437,284,294,10,False
-2,410,266,280,14,False
-2,383,248,270,22,False
-2,356,230,252,22,False
-2,329,212,234,22,False
-2,302,194,216,22,False
-2,275,176,204,28,False
-2,248,158,192,34,False
-2,221,140,174,34,False
-2,194,122,156,34,False
-2,167,104,138,34,False
1,140,104,120,16,False
1,113,113,126,13,False
1,122,122,120,-2,False
1,149,131,122,-9,False
1,176,140,132,-8,False
1,203,149,134,-15,False
1,230,158,144,-14,False
1,257,167,158,-9,False
1,284,176,152,-24,False
1,311,185,146,-39,False
1,338,194,164,-30,False
1,365,203,182,-21,False
1,392,212,200,-12,False
1,419,221,196,-25,False
1,446,230,212,-18,False
1,473,239,222,-17,False
1,500,248,240,-8,False
1,527,257,242,-15,False
1,554,266,223,-43,True
1,581,275,202,-73,True
1,608,284,229,-55,True
1,635,293,256,-37,True
1,662,302,283,-19,True
1,689,311,310,-1,True
1,716,320,331,11,True
1,743,329,310,-19,True
1,770,338,307,-31,True
1,797,347,334,-13,True
1,824,356,361,5,True
1,851,365,388,23,True
1,878,374,415,41,True
1,881,379,388,9,True
0,845,380,361,-19,True
0,809,380,364,-16,True
0,773,380,379,-1,True
0,737,380,388,8,True
0,701,380,385,5,True
0,665,380,358,-22,True
0,629,380,355,-25,True
0,593,380,364,-16,True
0,557,380,341,-39,False
0,521,380,359,-21,False
0,485,380,377,-3,False
0,449,380,383,3,False
0,413,380,365,-15,False
0,377,380,379,-1,False
0,341,380,385,5,False
0,305,380,367,-13,False
0,269,380,349,-31,False
0,233,380,367,-13,False
0,197,380,381,1,False
0,161,380,383,3,False
0,125,380,377,-3,False
0,89,380,371,-9,False
0,53,380,365,-15,False
0,17,380,371,-9,False
1,484,-41,369,410,True
1,448,-32,347,379,False
1,412,-23,329,352,False
1,376,-14,311,325,False
1,340,-5,293,298,False
1,304,4,275,271,False
1,268,13,257,244,False
1,232,22,239,217,False
1,196,31,221,190,False
1,160,40,203,163,False
1,124,49,185,136,False
1,88,58,167,109,False
1,52,67,149,82,False
1,16,76,131,55,False
1,484,204,129,-75,False
1,448,213,147,-66,False
1,412,222,165,-57,False
1,376,231,183,-48,False
1,340,240,201,-39,False
1,304,249,219,-30,False
1,268,258,237,-21,False
1,232,267,255,-12,False
1,196,276,273,-3,False
1,160,285,279,-6,False
1,124,294,285,-9,False
-2,120,291,295,4,False
-2,156,273,285,12,False
-2,192,255,275,20,False
-2,228,237,257,20,False
-2,264,219,239,20,False
-2,300,201,221,20,False
-2,336,183,203,20,False
-2,372,165,209,44,False
-2,408,147,191,44,False
-2,444,129,173,44,False
-2,480,111,155,44,False
1,516,102,137,35,True
1,552,111,128,17,True
1,588,120,107,-13,True
1,624,129,128,-1,True
1,660,138,125,-13,True
1,696,147,146,-1,True
1,732,156,149,-7,True
1,768,165,176,11,True
1,804,174,173,-1,True
1,840,183,176,-7,True
-2,876,192,191,-1,True
-2,840,174,188,14,True
-2,804,156,167,11,True
-2,768,138,146,8,True
-2,732,120,119,-1,True
-2,696,102,116,14,True
1,660,105,119,14,False
1,624,114,115,1,False
1,588,123,121,-2,False
1,552,132,127,-5,False
1,516,141,129,-12,False
1,480,150,135,-15,False
1,444,159,149,-10,False
1,408,168,157,-11,False
1,372,177,147,-30,False
1,336,186,165,-21,False
1,300,195,175,-20,False
1,264,204,177,-27,False
1,228,213,195,-18,False
1,192,222,197,-25,False
1,156,231,203,-28,False
1,120,240,221,-19,False
0,124,244,239,-5,False
0,160,244,257,13,False
0,196,244,255,11,False
0,232,244,245,1,False
0,268,244,243,-1,False
0,304,244,249,5,False
0,340,244,235,-9,False
0,376,244,229,-15,False
0,412,244,227,-17,False
0,448,244,241,-3,False
0,484,244,247,3,False
0,520,244,265,21,False
0,556,244,263,19,False
0,592,244,276,32,True
0,628,244,291,47,True
0,664,244,264,20,True
0,700,244,237,-7,True
0,736,244,240,-4,True
0,772,244,243,-1,True
0,808,244,240,-4,True
0,844,244,255,11,True
0,880,244,282,38,True
-2,884,246,255,9,True
-2,848,232,234,2,True
-2,812,214,207,-7,True
-2,776,196,207,11,True
-2,740,178,180,2,True
-2,704,160,178,18,False
-2,668,142,160,18,False
-2,632,124,142,18,False
-2,596,106,124,18,False
1,560,103,122,19,False
1,524,112,104,-8,False
1,488,121,102,-19,False
1,452,130,116,-14,False
1,416,139,134,-5,False
1,380,148,136,-12,False
1,344,157,154,-3,False
1,308,166,156,-10,False
1,272,175,170,-5,False
1,236,184,176,-8,False
1,200,193,194,1,False
1,164,202,204,2,False
1,128,211,210,-1,False
0,116,217,196,-21,False
0,152,217,206,-11,False
0,188,217,196,-21,False
0,224,217,214,-3,False
0,260,217,200,-17,False
0,296,217,202,-15,False
0,332,217,216,-1,False
0,368,217,218,1,False
0,404,217,212,-5,False
0,440,217,218,1,False
0,476,217,238,21,True
0,512,217,247,30,True
0,548,217,220,3,True
0,584,217,193,-24,True
0,620,217,214,-3,True
0,656,217,217,0,True
0,692,217,202,-15,True
0,728,217,223,6,True
0,764,217,208,-9,True
0,800,217,217,0,True
0,836,217,196,-21,True
0,872,217,193,-24,True
2,836,233,220,-13,True
2,791,251,241,-10,True
2,746,269,268,-1,True
2,701,287,283,-4,True
2,656,305,298,-7,True
2,611,323,325,2,True
2,566,341,326,-15,False
2,521,359,340,-19,False
2,476,377,352,-25,False
2,431,395,362,-33,False
2,386,413,380,-33,False
2,341,431,398,-33,False
2,296,449,416,-33,False
2,251,467,434,-33,False
2,206,485,452,-33,False
2,161,503,470,-33,False
2,116,521,488,-33,False
2,71,539,506,-33,False
2,26,557,520,-37,False
1,485,28,526,498,False
1,440,37,508,471,False
1,395,46,490,444,False
1,350,55,472,417,False
1,305,64,454,390,False
1,260,73,436,363,False
1,215,82,418,336,False
1,170,91,400,309,False
1,125,100,382,282,False
1,80,109,364,255,False
1,35,118,346,228,False
1,495,219,328,109,False
1,450,228,310,82,False
1,405,237,292,55,False
1,360,246,274,28,False
1,315,255,264,9,False
1,270,264,262,-2,False
1,225,273,260,-13,False
1,180,282,270,-12,False
1,135,291,288,-3,False
-1,110,296,294,-2,False
-1,155,287,288,1,False
-1,200,278,284,6,False
-1,245,269,274,5,False
-1,290,260,256,-4,False
-1,335,251,250,-1,False
-1,380,242,240,-2,False
-1,425,233,238,5,False
-1,470,224,248,24,False
-1,515,215,230,15,False
-1,560,206,212,6,False
-1,605,197,214,17,False
-1,650,188,224,36,True
-1,695,179,197,18,True
-1,740,170,173,3,True
-1,785,161,185,24,True
-1,830,152,170,18,True
-1,875,143,143,0,True
-2,840,126,134,8,True
-2,795,108,125,17,True
1,750,102,104,2,True
1,705,111,101,-10,True
1,660,120,116,-4,True
1,615,129,113,-16,True
1,570,138,131,-7,False
1,525,147,141,-6,False
1,480,156,151,-5,False
1,435,165,161,-4,False
1,390,174,171,-3,False
1,345,183,185,2,False
1,300,192,187,-5,False
1,255,201,191,-10,False
1,210,210,209,-1,False
1,165,219,217,-2,False
1,120,228,231,3,False
2,125,242,249,7,False
2,170,260,251,-9,False
2,215,278,269,-9,False
2,260,296,279,-17,False
2,305,314,297,-17,False
2,350,332,315,-17,False
2,395,350,333,-17,False
2,440,368,351,-17,False
2,485,386,369,-17,False
2,530,404,387,-17,False
2,575,422,405,-17,False
2,620,440,411,-29,False
2,665,458,430,-28,True
2,710,476,451,-25,True
2,755,494,466,-28,True
2,800,512,493,-19,True
2,845,530,514,-16,True
-2,870,540,541,1,True
-2,825,522,535,13,True
-2,780,504,508,4,True
-2,735,486,511,25,True
-2,690,468,508,40,True
-2,645,450,495,45,False
-2,600,432,477,45,False
-2,555,414,459,45,False
-2,510,396,445,49,False
-2,465,378,427,49,False
-2,420,360,409,49,False
-2,375,342,391,49,False
-2,330,324,373,49,False
-2,285,306,355,49,False
-2,240,288,337,49,False
-2,195,270,319,49,False
-2,150,252,301,49,False
-2,105,234,283,49,False
2,140,248,265,17,False
2,185,266,259,-7,False
2,230,284,277,-7,False
2,275,302,291,-11,False
2,320,320,297,-23,False
2,365,338,315,-23,False
2,410,356,333,-23,False
2,455,374,351,-23,False
2,500,392,375,-17,True
2,545,410,402,-8,True
2,590,428,423,-5,True
2,635,446,438,-8,True
2,680,464,459,-5,True
2,725,482,480,-2,True
2,770,500,507,7,True
2,815,518,498,-20,True
2,860,536,525,-11,True
0,855,544,546,2,True
0,810,544,549,5,True
0,765,544,546,2,True
0,720,544,549,5,True
0,675,544,543,-1,True
0,630,544,552,8,True
0,585,544,555,11,True
0,540,544,559,15,False
0,495,544,545,1,False
0,450,544,547,3,False
0,405,544,549,5,False
0,360,544,551,7,False
0,315,544,549,5,False
0,270,544,551,7,False
0,225,544,553,9,False
0,180,544,547,3,False
0,135,544,549,5,False
0,90,544,547,3,False
0,45,544,537,-7,False
0,0,544,543,-1,False
0,460,256,529,273,False
0,415,256,511,255,False
0,370,256,493,237,False
0,325,256,475,219,False
0,280,256,457,201,False
0,235,256,439,183,False
0,190,256,421,165,False
0,145,256,403,147,False
-2,100,256,385,129,False
-2,145,238,367,129,False
-2,190,220,349,129,False
-2,235,202,331,129,False
-2,280,184,313,129,False
-2,325,166,295,129,False
-2,370,148,277,129,False
-2,415,130,259,129,False
-2,460,112,241,129,False
1,505,100,223,123,False
1,550,109,205,96,False
1,595,118,187,69,False
1,640,127,169,42,False
1,685,136,151,15,False
1,730,145,145,0,False
1,775,154,159,5,True
1,820,163,150,-13,True
1,865,172,165,-7,True
1,850,181,180,-1,True
1,805,190,171,-19,True
1,760,199,162,-37,True
1,715,208,163,-45,False
1,670,217,181,-36,False
1,625,226,199,-27,False
1,580,235,217,-18,False
1,535,244,235,-9,False
1,490,253,241,-12,False
1,445,262,235,-27,False
1,400,271,253,-18,False
1,355,280,271,-9,False
1,310,289,277,-12,False
1,265,298,295,-3,False
1,220,307,305,-2,False
1,175,316,307,-9,False
1,130,325,325,0,False
2,115,337,323,-14,False
2,160,355,341,-14,False
2,205,373,359,-14,False
2,250,391,377,-14,False
2,295,409,387,-22,False
2,340,427,393,-34,False
2,385,445,411,-34,False
2,430,463,429,-34,False
2,475,481,447,-34,False
2,520,499,465,-34,False
2,565,517,483,-34,False
2,610,535,485,-50,False
2,655,553,503,-50,False
2,700,571,521,-50,False
2,745,589,539,-50,False
2,790,607,557,-50,False
2,835,625,581,-44,True
2,880,643,596,-47,True
2,826,661,611,-50,True
2,772,679,609,-70,False
2,718,697,627,-70,False
2,664,715,645,-70,False
2,610,733,663,-70,False
2,556,751,681,-70,False
2,502,769,699,-70,False
2,448,787,709,-78,False
2,394,805,727,-78,False
2,340,823,745,-78,False
2,286,841,763,-78,False
2,232,859,781,-78,False
2,178,877,799,-78,False
2,124,895,817,-78,False
-1,70,895,835,-60,False
-1,16,886,853,-33,False
-1,464,414,847,433,False
-1,410,405,829,424,False
-1,356,396,811,415,False
-1,302,387,793,406,False
-1,248,378,775,397,False
-1,194,369,757,388,False
-1,140,360,739,379,False
-1,86,351,721,370,False
-1,32,342,698,356,True
-1,482,585,674,89,False
-1,428,576,656,80,False
-1,374,567,638,71,False
-1,320,558,620,62,False
-1,266,549,602,53,False
-1,212,540,584,44,False
-1,158,531,566,35,False
-1,104,522,553,31,True
-1,50,513,526,13,True
-1,500,614,505,-109,False
-1,446,605,523,-82,False
-1,392,596,541,-55,False
-1,338,587,551,-36,False
-1,284,578,569,-9,False
-1,230,569,579,10,False
-1,176,560,561,1,False
-1,122,551,551,0,False
-1,140,542,549,7,False
-1,194,533,547,14,False
-1,248,524,533,9,False
-1,302,515,519,4,False
-1,356,506,537,31,False
-1,410,497,531,34,False
-1,464,488,525,37,False
-1,518,479,507,28,False
-1,572,470,505,35,False
-1,626,461,487,26,False
-1,680,452,469,17,False
-1,734,443,455,12,False
-1,788,434,453,19,False
-1,842,425,439,14,False
-1,860,416,419,3,True
-1,806,407,408,1,False
-1,752,398,410,12,False
-1,698,389,412,23,False
-1,644,380,394,14,False
-1,590,371,384,13,False
-1,536,362,370,8,False
-1,482,353,380,27,False
-1,428,344,378,34,False
-1,374,335,360,25,False
-1,320,326,342,16,False
-1,266,317,324,7,False
-1,212,308,326,18,False
-1,158,299,312,13,False
-1,104,290,294,4,False
-1,50,281,300,19,False
-1,500,406,282,-124,False
-1,446,397,300,-97,False
-1,392,388,318,-70,False
-1,338,379,336,-43,False
-1,284,370,354,-16,False
-1,230,361,372,11,False
-1,176,352,358,6,False
-1,122,343,372,29,False
-1,68,334,362,28,False
-1,14,325,380,55,False
-1,464,342,362,20,False
-1,410,333,344,11,False
-1,356,324,346,22,False
-1,302,315,328,13,False
-1,248,306,318,12,False
-1,194,297,316,19,False
-1,140,288,298,10,False
1,122,285,288,3,False
1,176,294,286,-8,False
1,230,303,296,-7,False
1,284,312,310,-2,False
1,338,321,322,1,False
1,392,330,332,2,False
1,446,339,350,11,False
1,500,348,348,0,False
1,554,357,338,-19,False
1,608,366,348,-18,False
1,662,375,366,-9,False
1,716,384,359,-25,True
1,770,393,368,-25,True
1,824,402,395,-7,True
0,878,411,401,-10,True
0,824,411,410,-1,True
0,770,411,425,14,True
0,716,411,410,-1,True
0,662,411,404,-7,False
0,608,411,406,-5,False
0,554,411,424,13,False
0,500,411,426,15,False
0,446,411,408,-3,False
0,392,411,426,15,False
0,338,411,416,5,False
0,284,411,414,3,False
0,230,411,408,-3,False
0,176,411,394,-17,False
0,122,411,412,1,False
0,68,411,418,7,False
0,14,411,432,21,False
0,464,182,414,232,False
0,410,182,396,214,False
0,356,182,378,196,False
0,302,182,360,178,False
0,248,182,342,160,False
0,194,182,324,142,False
0,140,182,306,124,False
0,86,182,288,106,False
0,32,182,270,88,False
0,482,264,264,0,False
0,428,264,266,2,False
0,374,264,272,8,False
0,320,264,270,6,False
0,266,264,264,0,False
0,212,264,272,8,False
0,158,264,274,10,False
0,104,264,268,4,False
0,50,264,270,6,False
0,500,346,252,-94,False
0,446,346,270,-76,False
0,392,346,288,-58,False
0,338,346,306,-40,False
0,284,346,324,-22,False
0,230,346,330,-16,False
0,176,346,346,0,False
0,122,346,356,10,False
1,140,352,354,2,False
1,194,361,352,-9,False
1,248,370,370,0,False
1,302,379,380,1,False
1,356,388,374,-14,False
1,410,397,388,-9,False
1,464,406,406,0,False
1,518,415,412,-3,False
1,572,424,418,-6,False
1,626,433,428,-5,False
1,680,442,435,-7,True
1,734,451,432,-19,True
1,788,460,459,-1,True
1,842,469,468,-1,True
-1,860,472,441,-31,True
-1,806,463,462,-1,True
-1,752,454,471,17,True
-1,698,445,444,-1,True
-1,644,436,437,1,False
-1,590,427,427,0,False
-1,536,418,425,7,False
-1,482,409,423,14,False
-1,428,400,417,17,False
-1,374,391,399,8,False
-1,320,382,381,-1,False
-1,266,373,375,2,False
-1,212,364,373,9,False
-1,158,355,363,8,False
-2,104,346,357,11,False
-2,158,328,339,11,False
-2,212,310,325,15,False
-2,266,292,311,19,False
-2,320,274,293,19,False
-2,374,256,275,19,False
-2,428,238,261,23,False
-2,482,220,251,31,False
-2,536,202,241,39,False
-2,590,184,223,39,False
-2,644,166,205,39,False
-2,698,148,187,39,False
-2,752,130,169,39,False
-2,806,112,145,33,True
1,860,100,124,24,True
1,842,103,109,6,True
1,788,112,112,0,True
1,734,121,108,-13,False
1,680,130,122,-8,False
1,626,139,132,-7,False
1,572,148,142,-6,False
1,518,157,156,-1,False
1,464,166,170,4,False
1,410,175,180,5,False
1,356,184,198,14,False
1,302,193,188,-5,False
1,248,202,206,4,False
1,194,211,216,5,False
1,140,220,224,4,False
0,125,226,226,0,False
0,188,226,224,-2,False
0,251,226,222,-4,False
0,314,226,232,6,False
0,377,226,222,-4,False
0,440,226,224,-2,False
0,503,226,210,-16,False
0,566,226,216,-10,True
0,629,226,237,11,True
0,692,226,234,8,True
0,755,226,231,5,True
0,818,226,216,-10,True
-2,881,226,231,5,True
-2,818,208,228,20,True
-2,755,190,213,23,True
-2,692,172,186,14,True
-2,629,154,168,14,False
-2,566,136,154,18,False
-2,503,118,136,18,False
-2,440,100,122,22,False
1,377,106,124,18,False
1,314,115,138,23,False
1,251,124,140,16,False
1,188,133,134,1,False
1,125,142,144,2,False
0,146,145,134,-11,False
0,209,145,144,-1,False
0,272,145,146,1,False
0,335,145,140,-5,False
0,398,145,146,1,False
0,461,145,146,1,False
0,524,145,136,-9,False
0,587,145,146,1,False
0,650,145,141,-4,True
0,713,145,138,-7,True
0,776,145,147,2,True
0,839,145,156,11,True
0,860,145,138,-7,True
0,797,145,144,-1,True
0,734,145,141,-4,True
0,671,145,138,-7,True
0,608,145,159,14,True
0,545,145,144,-1,True
0,482,145,143,-2,False
0,419,145,153,8,False
0,356,145,147,2,False
0,293,145,147,2,False
0,230,145,137,-8,False
0,167,145,147,2,False
-1,104,145,145,0,False
-1,167,136,143,7,False
-1,230,127,135,8,False
-1,293,118,133,15,False
-1,356,109,131,22,False
-1,419,100,113,13,False
1,482,107,115,8,False
1,545,116,117,1,True
1,608,125,126,1,True
1,671,134,135,1,True
1,734,143,138,-5,True
1,797,152,147,-5,True
1,860,161,153,-8,True
-2,839,152,168,16,True
-2,776,134,141,7,True
-2,713,116,126,10,True
1,650,98,105,7,True
1,587,107,96,-11,False
1,524,116,106,-10,False
1,461,125,116,-9,False
1,398,134,130,-4,False
1,335,143,136,-7,False
1,272,152,138,-14,False
1,209,161,156,-5,False
1,146,170,154,-16,False
0,125,176,168,-8,False
0,188,176,170,-6,False
0,251,176,188,12,False
0,314,176,186,10,False
0,377,176,180,4,False
0,440,176,186,10,False
0,503,176,178,2,False
0,566,176,164,-12,False
0,629,176,167,-9,True
0,692,176,158,-18,True
0,755,176,161,-15,True
0,818,176,173,-3,True
0,881,176,191,15,True
0,809,176,188,12,True
0,737,176,173,-3,True
0,665,176,170,-6,True
0,593,176,185,9,True
0,521,176,186,10,False
0,449,176,182,6,False
0,377,176,188,12,False
0,305,176,170,-6,False
0,233,176,170,-6,False
0,161,176,180,4,False
-1,105,175,190,15,False
-1,177,166,188,22,False
-1,249,157,182,25,False
-1,321,148,180,32,False
-1,393,139,170,31,False
-1,465,130,152,22,False
-1,537,121,134,13,False
-1,609,112,116,4,False
-1,681,103,116,13,True
1,753,104,110,6,True
1,825,113,113,0,True
0,865,120,122,2,True
0,793,120,125,5,True
0,721,120,122,2,True
0,649,120,124,4,False
0,577,120,120,0,False
0,505,120,122,2,False
0,433,120,124,4,False
0,361,120,134,14,False
0,289,120,122,2,False
0,217,120,124,4,False
0,145,120,122,2,False
0,73,120,124,4,False
0,1,120,122,2,False
0,436,160,136,-24,False
0,364,160,146,-14,False
0,292,160,152,-8,False
0,220,160,162,2,False
0,148,160,164,4,False
0,124,160,166,6,False
0,196,160,164,4,False
0,268,160,166,6,False
0,340,160,168,8,False
0,412,160,158,-2,False
0,484,160,160,0,False
0,556,160,158,-2,False
0,628,160,160,0,True
0,700,160,145,-15,True
0,772,160,166,6,True
0,844,160,151,-9,True
0,836,160,166,6,True
0,764,160,157,-3,True
0,692,160,157,-3,True
0,620,160,172,12,True
0,548,160,171,11,False
0,476,160,173,13,False
0,404,160,171,11,False
0,332,160,173,13,False
0,260,160,167,7,False
0,188,160,177,17,False
0,116,160,167,7,False
-2,156,146,161,15,False
-2,228,128,143,15,False
-2,300,110,125,15,False
1,372,101,111,10,False
1,444,110,97,-13,False
1,516,119,107,-12,False
1,588,128,125,-3,False
1,660,137,132,-5,True
1,732,146,141,-5,True
1,804,155,156,1,True
-2,876,164,171,7,True
-2,795,146,156,10,True
-2,714,128,129,1,True
-2,633,110,120,10,True
1,552,101,102,1,False
1,471,110,100,-10,False
1,390,119,102,-17,False
1,309,128,118,-10,False
1,228,137,128,-9,False
1,147,146,134,-12,False
-1,138,147,136,-11,False
-1,219,138,138,0,False
-1,300,129,128,-1,False
-1,381,120,124,4,False
-1,462,111,126,15,False
-1,543,102,116,14,False
1,624,105,100,-5,True
1,705,114,103,-11,True
1,786,123,121,-2,True
1,867,132,130,-2,True
-1,804,125,139,14,True
-1,723,116,124,8,True
-1,642,107,103,-4,True
1,561,100,106,6,False
1,480,109,108,-1,False
1,399,118,118,0,False
1,318,127,120,-7,False
1,237,136,134,-2,False
1,156,145,140,-5,False
2,129,157,154,-3,False
2,210,175,164,-11,False
2,291,193,178,-15,False
2,372,211,196,-15,False
2,453,229,210,-19,False
2,534,247,228,-19,False
2,615,265,237,-28,True
2,696,283,264,-19,True
2,777,301,291,-10,True
2,858,319,318,-1,True
-2,813,309,333,24,True
-2,732,291,336,45,True
-2,651,273,309,36,True
-2,570,255,285,30,False
-2,489,237,267,30,False
-2,408,219,249,30,False
-2,327,201,231,30,False
-2,246,183,213,30,False
-2,165,165,195,30,False
1,120,153,189,36,False
1,201,162,175,13,False
1,282,171,169,-2,False
1,363,180,175,-5,False
1,444,189,181,-8,False
1,525,198,177,-21,False
1,606,207,195,-12,True
1,687,216,204,-12,True
1,768,225,219,-6,True
1,849,234,222,-12,True
0,816,237,237,0,True
0,726,237,252,15,True
0,636,237,237,0,True
0,546,237,235,-2,False
0,456,237,241,4,False
0,366,237,243,6,False
0,276,237,241,4,False
0,186,237,239,2,False
-2,96,237,241,4,False
-2,186,219,235,16,False
-2,276,201,219,18,False
-2,366,183,201,18,False
-2,456,165,187,22,False
-2,546,147,169,22,False
-2,636,129,148,19,True
-2,726,111,124,13,True
1,816,102,106,4,True
0,846,108,88,-20,True
0,756,108,97,-11,True
0,666,108,106,-2,True
0,576,108,107,-1,False
0,486,108,105,-3,False
0,396,108,101,-7,False
0,306,108,107,-1,False
0,216,108,99,-9,False
0,126,108,97,-11,False
0,156,108,103,-5,False
0,246,108,109,1,False
0,336,108,107,-1,False
0,426,108,109,1,False
0,516,108,115,7,False
0,606,108,113,5,True
0,696,108,104,-4,True
0,786,108,95,-13,True
-2,876,108,104,-4,True
1,786,102,107,5,True
1,696,111,116,5,True
1,606,120,113,-7,True
1,516,129,122,-7,False
1,426,138,132,-6,False
1,336,147,146,-1,False
1,246,156,156,0,False
1,156,165,162,-3,False
-1,129,168,152,-16,False
-1,228,159,162,3,False
-1,327,150,160,10,False
-1,426,141,150,9,False
-1,525,132,136,4,False
-1,624,123,138,15,True
-1,723,114,120,6,True
-1,822,105,99,-6,True
1,833,102,102,0,True
1,734,111,105,-6,True
1,635,120,120,0,True
1,536,129,130,1,False
1,437,138,136,-2,False
1,338,147,142,-5,False
1,239,156,148,-8,False
1,140,165,150,-15,False
-2,151,159,164,5,False
-2,250,141,158,17,False
-2,349,123,144,21,False
-2,448,105,132,27,False
1,547,105,114,9,False
1,646,114,106,-8,True
1,745,123,109,-14,True
1,844,132,124,-8,True
2,811,147,142,-5,True
2,712,165,145,-20,True
2,613,183,172,-11,True
2,514,201,178,-23,False
2,415,219,192,-27,False
2,316,237,210,-27,False
2,217,255,228,-27,False
2,118,273,246,-27,False
-1,180,270,260,-10,False
-1,288,261,262,1,False
-1,396,252,252,0,False
-1,504,243,254,11,False
-1,612,234,251,17,True
-1,720,225,227,2,True
-1,828,216,230,14,True
1,816,217,215,-2,True
1,708,226,212,-14,True
1,600,235,224,-11,True
1,492,244,239,-5,False
1,384,253,253,0,False
1,276,262,255,-7,False
1,168,271,269,-2,False
1,132,280,271,-9,False
1,240,289,285,-4,False
1,348,298,295,-3,False
1,456,307,293,-14,False
1,564,316,303,-13,False
1,672,325,327,2,True
1,780,334,336,2,True
-1,864,341,339,-2,True
-1,756,332,336,4,True
-1,648,323,333,10,True
-1,540,314,334,20,False
-1,432,305,316,11,False
-1,324,296,306,10,False
-1,216,287,296,9,False
-1,108,278,282,4,False
-2,192,261,268,7,False
-2,300,243,260,17,False
-2,408,225,242,17,False
-2,516,207,228,21,False
-2,624,189,208,19,True
-2,732,171,187,16,True
-2,840,153,172,19,True
2,798,159,157,-2,True
2,681,177,163,-14,True
2,564,195,174,-21,False
2,447,213,192,-21,False
2,330,231,210,-21,False
2,213,249,228,-21,False
2,96,267,242,-25,False
2,213,285,260,-25,False
2,330,303,278,-25,False
2,447,321,296,-25,False
2,564,339,310,-29,False
2,681,357,322,-35,True
2,798,375,343,-32,True
1,837,390,364,-26,True
1,720,399,391,-8,True
1,603,408,400,-8,True
1,486,417,415,-2,False
1,369,426,417,-9,False
1,252,435,423,-12,False
1,135,444,429,-15,False
1,18,453,447,-6,False
1,409,105,437,332,False
1,292,114,419,305,False
1,175,123,401,278,False
1,139,132,383,251,False
1,265,141,365,224,False
1,391,150,347,197,False
1,517,159,329,170,False
1,643,168,308,140,True
1,769,177,281,104,True
1,895,186,254,68,True
1,514,231,232,1,False
1,640,240,232,-8,True
1,766,249,220,-29,True
-2,864,255,247,-8,True
-2,738,237,262,25,True
-2,612,219,247,28,True
-2,486,201,232,31,False
-2,360,183,214,31,False
-2,234,165,196,31,False
-2,108,147,178,31,False
-1,206,137,160,23,False
-1,332,128,142,14,False
-1,458,119,134,15,False
-1,584,110,120,10,False
-1,710,101,105,4,True
1,836,106,108,2,True
-1,794,103,111,8,True
1,668,104,108,4,True
1,542,113,105,-8,False
1,416,122,111,-11,False
1,290,131,119,-12,False
1,164,140,133,-7,False
-1,154,141,147,6,False
-1,289,132,137,5,False
-1,424,123,133,10,False
-1,559,114,123,9,False
-1,694,105,111,6,True
1,829,102,96,-6,True
0,814,106,99,-7,True
0,679,106,102,-4,True
0,544,106,103,-3,False
0,409,106,109,3,False
0,274,106,107,1,False
0,139,106,105,-1,False
2,184,118,107,-11,False
2,319,136,125,-11,False
2,454,154,143,-11,False
2,589,172,157,-15,False
2,724,190,171,-19,True
2,859,208,198,-10,True
1,777,219,219,0,True
1,633,228,228,0,True
1,489,237,237,0,False
1,345,246,241,-5,False
1,201,255,251,-4,False
1,121,264,261,-3,False
1,265,273,265,-8,False
1,409,282,283,1,False
1,553,291,265,-26,False
1,697,300,275,-25,True
1,841,309,296,-13,True
1,793,318,311,-7,True
1,649,327,319,-8,False
1,505,336,325,-11,False
1,361,345,339,-6,False
1,217,354,349,-5,False
-2,105,360,355,-5,False
-2,249,342,347,5,False
-2,393,324,333,9,False
-2,537,306,323,17,False
-2,681,288,313,25,True
-2,825,270,298,28,True
-2,969,252,289,37,True
-2,612,269,273,4,False
-2,756,251,263,12,True
0,867,235,254,19,True
0,714,235,247,12,False
0,561,235,241,6,False
0,408,235,241,6,False
0,255,235,229,-6,False
0,102,235,235,0,False
0,466,264,233,-31,False
0,313,264,249,-15,False
0,160,264,261,-3,False
-2,177,254,259,5,False
-2,330,236,249,13,False
-2,483,218,231,13,False
-2,636,200,217,17,False
-2,789,182,198,16,True
0,840,170,180,10,True
0,687,170,171,1,False
0,534,170,171,1,False
0,381,170,165,-5,False
0,228,170,171,1,False
0,75,170,169,-1,False
0,432,202,179,-23,False
0,279,202,193,-9,False
0,126,202,205,3,False
0,218,202,207,5,False
0,380,202,201,-1,False
0,542,202,205,3,False
0,704,202,204,2,True
0,866,202,192,-10,True
1,740,210,204,-6,True
1,578,219,212,-7,False
1,416,228,218,-10,False
1,254,237,224,-13,False
-1,92,246,236,-10,False
-1,263,237,236,-1,False
-1,434,228,230,2,False
-1,605,219,228,9,False
-1,776,210,217,7,True
2,833,210,208,-2,True
2,662,228,223,-5,False
2,491,246,233,-13,False
2,320,264,249,-15,False
2,149,282,267,-15,False
2,206,300,285,-15,False
2,377,318,299,-19,False
2,548,336,313,-23,False
2,719,354,333,-21,True
0,890,372,360,-12,True
0,710,372,375,3,True
0,530,372,379,7,False
0,350,372,383,11,False
0,170,372,377,5,False
1,190,377,383,6,False
1,370,386,387,1,False
1,550,395,401,6,False
1,730,404,407,3,True
0,870,412,416,4,True
0,690,412,407,-5,True
0,510,412,414,2,False
0,330,412,422,10,False
0,150,412,420,8,False
0,480,174,410,236,False
0,300,174,392,218,False
0,120,174,374,200,False
2,268,190,356,166,False
2,457,208,338,130,False
2,646,226,320,94,False
2,835,244,295,51,True
2,521,273,269,-4,False
2,710,291,272,-19,True
-2,857,305,299,-6,True
-2,668,287,308,21,False
-2,479,269,294,25,False
-2,290,251,276,25,False
0,101,233,266,33,False
0,299,233,252,19,False
0,497,233,238,5,False
0,695,233,236,3,True
-2,893,233,239,6,True
-2,695,215,236,21,True
-2,497,197,217,20,False
-2,299,179,203,24,False
1,101,161,185,24,False
1,308,170,175,5,False
1,515,179,173,-6,False
1,722,188,177,-11,True
-1,837,193,192,-1,True
-1,630,184,178,-6,False
-1,423,175,174,-1,False
-1,216,166,176,10,False
2,194,169,174,5,False
2,401,187,176,-11,False
2,608,205,186,-19,False
2,815,223,209,-14,True
2,746,241,230,-11,True
2,539,259,243,-16,False
2,332,277,261,-16,False
2,125,295,279,-16,False
0,287,297,297,0,False
0,494,297,299,2,False
0,701,297,297,0,False
2,862,299,305,6,True
2,655,317,312,-5,False
2,448,335,326,-9,False
2,241,353,340,-13,False
0,173,365,354,-11,False
0,380,365,364,-1,False
0,587,365,366,1,False
0,794,365,374,9,True
2,771,375,383,8,True
2,564,393,374,-19,False
2,357,411,392,-19,False
2,150,429,406,-23,False
2,454,170,412,242,False
2,247,188,394,206,False
-1,133,200,376,176,False
-1,340,191,358,167,False
-1,547,182,340,158,False
-1,754,173,319,146,True
-1,961,164,292,128,True
-1,661,279,284,5,False
-1,868,270,276,6,True
1,707,277,273,-4,True
1,500,286,273,-13,False
1,293,295,279,-16,False
0,86,304,293,-11,False
0,294,304,303,-1,False
0,501,304,297,-7,False
0,708,304,303,-1,False
-1,869,303,305,2,True
-1,662,294,307,13,False
-1,455,285,305,20,False
-1,248,276,291,15,False
-2,134,265,277,12,False
-2,341,247,263,16,False
-2,548,229,245,16,False
-2,755,211,231,20,False
-1,824,196,211,15,True
-1,617,187,198,11,False
-1,410,178,190,12,False
-1,203,169,184,15,False
-1,500,268,170,-98,False
-1,293,259,188,-71,False
0,86,250,206,-44,False
0,294,250,224,-26,False
0,501,250,238,-12,False
0,708,250,234,-16,False
2,869,252,238,-14,True
2,662,270,247,-23,False
2,455,288,261,-27,False
2,248,306,275,-31,False
2,134,324,293,-31,False
2,341,342,311,-31,False
2,548,360,329,-31,False
2,755,378,347,-31,True
-1,824,387,368,-19,True
-1,617,378,377,-1,False
-1,410,369,379,10,False
-1,203,360,373,13,False
0,181,355,363,8,False
0,388,355,365,10,False
0,595,355,363,8,False
0,802,355,366,11,True
-2,779,345,375,30,True
-2,572,327,365,38,False
-2,365,309,347,38,False
-2,158,291,329,38,False
0,228,285,311,26,False
0,435,285,293,8,False
0,642,285,287,2,False
0,849,285,294,9,True
-2,734,271,285,14,True
-2,527,253,282,29,False
-2,320,235,264,29,False
-2,113,217,246,29,False
-2,275,199,228,29,False
-2,482,181,210,29,False
-2,689,163,192,29,True
-2,896,145,171,26,True
-2,592,154,158,4,False
-2,799,136,148,12,True
0,776,128,133,5,True
0,569,128,131,3,False
0,362,128,133,5,False
0,155,128,129,1,False
0,454,184,131,-53,False
0,247,184,149,-35,False
0,133,184,163,-21,False
0,340,184,173,-11,False
0,547,184,173,-11,False
0,754,184,180,-4,True
-2,823,178,183,5,True
-2,616,160,170,10,False
-2,409,142,154,12,False
-2,202,124,136,12,False
-2,500,216,122,-94,False
-2,293,198,140,-58,False
-2,86,180,158,-22,False
-2,385,250,176,-74,False
-2,178,232,194,-38,False
-2,477,288,204,-84,False
-2,270,270,222,-48,False
-2,63,252,240,-12,False
-2,362,278,250,-28,False
-2,155,260,268,8,False
-2,454,286,266,-20,False
-2,247,268,280,12,False
1,133,256,266,10,False
1,340,265,268,3,False
1,547,274,274,0,False
1,754,283,276,-7,True
-2,823,283,291,8,True
-2,616,265,278,13,False
-2,409,247,260,13,False
-2,202,229,246,17,False
1,180,223,232,9,False
1,387,232,226,-6,False
1,594,241,242,1,False
1,801,250,247,-3,True
2,778,264,256,-8,True
2,571,282,273,-9,False
2,364,300,279,-21,False
2,157,318,297,-21,False
0,227,324,315,-9,False
0,434,324,323,-1,False
0,641,324,337,13,False
0,848,324,324,0,True
1,733,331,324,-7,True
1,526,340,337,-3,False
1,319,349,339,-10,False
1,112,358,353,-5,False
2,274,375,363,-12,False
2,481,393,373,-20,False
2,688,411,391,-20,True
-1,895,429,412,-17,True
-1,688,420,421,1,True
-1,481,411,418,7,False
-1,274,402,408,6,False
-1,67,393,406,13,False
-1,362,170,388,218,False
-1,155,161,370,209,False
0,225,158,352,194,False
0,432,158,334,176,False
0,639,158,316,158,False
0,846,158,291,133,True
0,546,270,270,0,False
0,753,270,279,9,True
-2,822,264,276,12,True
-2,615,246,267,21,False
-2,408,228,253,25,False
-2,201,210,235,25,False
0,179,200,217,17,False
0,386,200,207,7,False
0,593,200,197,-3,False
0,800,200,198,-2,True
-2,777,190,195,5,True
-2,570,172,182,10,False
-2,363,154,172,18,False
-2,156,136,158,22,False
-2,454,172,152,-20,False
-2,247,154,154,0,False
-2,40,136,148,12,False
-2,339,162,156,-6,False
-2,132,144,154,10,False
-2,431,170,152,-18,False
-2,224,152,154,2,False
-2,17,134,144,10,False
-2,316,160,156,-4,False
-2,109,142,150,8,False
-2,408,168,152,-16,False
-2,201,150,158,8,False
-2,500,176,148,-28,False
-2,293,158,156,-2,False
-2,86,140,144,4,False
-2,385,166,150,-16,False
-2,178,148,158,10,False
-2,477,174,148,-26,False
-2,270,156,166,10,False
-2,63,138,152,14,False
-2,362,164,158,-6,False
-2,155,146,154,8,False
-2,454,172,148,-24,False
-2,247,154,162,8,False
-2,40,136,146,10,False
-2,339,162,156,-6,False
-2,132,144,152,8,False
-2,431,170,146,-24,False
-2,224,152,156,4,False
-2,17,134,142,8,False
-2,316,160,156,-4,False
-2,109,142,148,6,False
-2,408,168,146,-22,False
-2,201,150,156,6,False
-2,500,176,142,-34,False
-2,293,158,152,-6,False
-2,86,140,142,2,False
-2,385,166,144,-22,False
-2,178,148,152,4,False
-2,477,174,142,-32,False
-2,270,156,160,4,False
-2,63,138,142,4,False
-2,362,164,148,-16,False
-2,155,146,146,0,False
-2,454,172,140,-32,False
-2,247,154,154,0,False
-2,40,136,144,8,False
-2,339,162,154,-8,False
-2,132,144,146,2,False
-2,431,170,144,-26,False
-2,224,152,154,2,False
-2,17,134,140,6,False
-2,316,160,154,-6,False
-2,109,142,146,4,False
-2,408,168,148,-20,False
-2,201,150,154,4,False
-2,500,176,140,-36,False
-2,293,158,158,0,False
-2,86,140,144,4,False
-2,385,166,146,-20,False
-2,178,148,148,0,False
-2,477,174,140,-34,False
-2,270,156,158,2,False
-2,63,138,142,4,False
-2,362,164,148,-16,False
-2,155,146,146,0,False
-2,454,172,140,-32,False
-2,247,154,154,0,False
-2,40,136,142,6,False
-2,339,162,152,-10,False
-2,132,144,148,4,False
-2,431,170,142,-28,False
-2,224,152,154,2,False
-2,17,134,140,6,False
-2,316,160,154,-6,False
-2,109,142,142,0,False
-2,408,168,144,-24,False
-2,201,150,152,2,False
-2,500,176,140,-36,False
-2,293,158,154,-4,False
-2,86,140,144,4,False
-2,385,166,150,-16,False
-2,178,148,154,6,False
-2,477,174,140,-34,False
-2,270,156,158,2,False
-2,63,138,144,6,False
-2,362,164,150,-14,False
-2,155,146,150,4,False
-2,454,172,142,-30,False
-2,247,154,156,2,False
-2,40,136,140,4,False
-2,339,162,150,-12,False
-2,132,144,146,2,False
-2,431,170,140,-30,False
-2,224,152,152,0,False
-2,17,134,136,2,False
-2,316,160,150,-10,False
-2,109,142,142,0,False
-2,408,168,140,-28,False
-2,201,150,148,-2,False
-2,500,176,134,-42,False
-2,293,158,152,-6,False
-2,86,140,140,0,False
-2,385,166,142,-24,False
-2,178,148,148,0,False
-2,477,174,136,-38,False
-2,270,156,154,-2,False
-2,63,138,142,4,False
-2,362,164,148,-16,False
-2,155,146,150,4,False
-2,454,172,140,-32,False
-2,247,154,154,0,False
-2,40,136,138,2,False
-2,339,162,148,-14,False
-2,132,144,144,0,False
-2,431,170,140,-30,False
-2,224,152,154,2,False
-2,17,134,136,2,False
-2,316,160,150,-10,False
-2,109,142,146,4,False
-2,408,168,144,-24,False
-2,201,150,152,2,False
-2,500,176,136,-40,False
-2,293,158,154,-4,False
-2,86,140,144,4,False
-2,385,166,146,-20,False
-2,178,148,150,2,False
-2,477,174,138,-36,False
-2,270,156,156,0,False
-2,63,138,140,2,False
-2,362,164,146,-18,False
-2,155,146,148,2,False
-2,454,172,140,-32,False
-2,247,154,154,0,False
-2,40,136,140,4,False
-2,339,162,150,-12,False
-2,132,144,148,4,False
-2,431,170,142,-28,False
-2,224,152,154,2,False
-2,17,134,136,2,False
-2,316,160,150,-10,False
-2,109,142,144,2,False
-2,408,168,142,-26,False
-2,201,150,152,2,False
-2,500,176,134,-42,False
-2,293,158,152,-6,False
-2,86,140,142,2,False
-2,385,166,144,-22,False
-2,178,148,150,2,False
-2,477,174,138,-36,False
-2,270,156,156,0,False
-2,63,138,140,2,False
-2,362,164,146,-18,False
-2,155,146,148,2,False
-2,454,172,138,-34,False
-2,247,154,156,2,False
-2,40,136,138,2,False
-2,339,162,148,-14,False
-2,132,144,146,2,False
-2,431,170,140,-30,False
-2,224,152,154,2,False
-2,17,134,136,2,False
-2,316,160,150,-10,False
-2,109,142,144,2,False
-2,408,168,142,-26,False
-2,201,150,152,2,False
-2,500,176,134,-42,False
-2,293,158,152,-6,False
-2,86,140,142,2,False
-2,385,166,144,-22,False
-2,178,148,150,2,False
-2,477,174,136,-38,False
-2,270,156,154,-2,False
-2,63,138,140,2,False
-2,362,164,146,-18,False
-2,155,146,148,2,False
-2,454,172,138,-34,False
-2,247,154,156,2,False
-2,40,136,138,2,False
-2,339,162,148,-14,False
-2,132,144,146,2,False
-2,431,170,140,-30,False
-2,224,152,154,2,False
-2,17,134,136,2,False
-2,316,160,150,-10,False
-2,109,142,144,2,False
-2,408,168,142,-26,False
-2,201,150,152,2,False
-2,500,176,134,-42,False
-2,293,158,152,-6,False
-2,86,140,142,2,False
-2,385,166,144,-22,False
-2,178,148,150,2,False
-2,477,174,136,-38,False
-2,270,156,154,-2,False
-2,63,138,140,2,False
-2,362,164,146,-18,False
-2,155,146,148,2,False
-2,454,172,138,-34,False
-2,247,154,156,2,False
-2,40,136,138,2,False
-2,339,162,148,-14,False
-2,132,144,146,2,False
-2,431,170,140,-30,False
-2,224,152,154,2,False
-2,17,134,136,2,False
-2,316,160,150,-10,False
-2,109,142,144,2,False
-2,408,168,142,-26,False
-2,201,150,152,2,False
-2,500,176,134,-42,False
-2,293,158,152,-6,False
-2,86,140,142,2,False
-2,385,166,144,-22,False
-2,178,148,150,2,False
-2,477,174,136,-38,False
-2,270,156,154,-2,False
-2,63,138,140,2,False
-2,362,164,146,-18,False
-2,155,146,148,2,False
-2,454,172,138,-34,False
-2,247,154,156,2,False
-2,40,136,138,2,False
-2,339,162,148,-14,False
-2,132,144,146,2,False
-2,431,170,140,-30,False
-2,224,152,154,2,False
-2,17,134,136,2,False
-2,316,160,150,-10,False
-2,109,142,144,2,False
-2,408,168,142,-26,False
-2,201,150,152,2,False
-2,500,176,134,-42,False
-2,293,158,152,-6,False
-2,86,140,142,2,False
-2,385,166,144,-22,False
-2,178,148,150,2,False
-2,477,174,136,-38,False
-2,270,156,154,-2,False
-2,63,138,140,2,False
-2,362,164,146,-18,False
-2,155,146,148,2,False
-2,454,172,138,-34,False
-2,247,154,156,2,False
-2,40,136,138,2,False
-2,339,162,148,-14,False
-2,132,144,146,2,False
-2,431,170,140,-30,False
-2,224,152,154,2,False
-2,17,134,136,2,False
-2,316,160,150,-10,False
-2,109,142,144,2,False
-2,408,168,142,-26,False
-2,201,150,152,2,False
-2,500,176,134,-42,False
-2,293,158,152,-6,False
-2,86,140,142,2,False
-2,385,166,144,-22,False
-2,178,148,150,2,False
-2,477,174,136,-38,False
-2,270,156,154,-2,False
-2,63,138,140,2,False
-2,362,164,146,-18,False
-2,155,146,148,2,False
-2,454,172,138,-34,False
-2,247,154,156,2,False
-2,40,136,138,2,False
-2,339,162,148,-14,False
-2,132,144,146,2,False
-2,431,170,140,-30,False
-2,224,152,154,2,False
-2,17,134,136,2,False
-2,316,160,150,-10,False
-2,109,142,144,2,False
-2,408,168,142,-26,False
-2,201,150,152,2,False
-2,500,176,134,-42,False
-2,293,158,152,-6,False
-2,86,140,142,2,False
-2,385,166,144,-22,False
-2,178,148,150,2,False
-2,477,174,136,-38,False
-2,270,156,154,-2,False
-2,63,138,140,2,False
-2,362,164,146,-18,False
-2,155,146,148,2,False
-2,454,172,138,-34,False
-2,247,154,156,2,False
-2,40,136,138,2,False
-2,339,162,148,-14,False
-2,132,144,146,2,False
-2,431,170,140,-30,False
-2,224,152,154,2,False
-2,17,134,136,2,False
-2,316,160,150,-10,False
-2,109,142,144,2,False
-2,408,168,142,-26,False
-2,201,150,152,2,False
-2,500,176,134,-42,False
-2,293,158,152,-6,False
-2,86,140,142,2,False
-2,385,166,144,-22,False
-2,178,148,150,2,False
-2,477,174,136,-38,False
-2,270,156,154,-2,False
-2,63,138,140,2,False
-2,362,164,146,-18,False
-2,155,146,148,2,False
-2,454,172,138,-34,False
-2,247,154,156,2,False
-2,40,136,138,2,False
-2,339,162,148,-14,False
-2,132,144,146,2,False
-2,431,170,140,-30,False
-2,224,152,154,2,False
-2,17,134,136,2,False
-2,316,160,150,-10,False
-2,109,142,144,2,False
-2,408,168,142,-26,False
-2,201,150,152,2,False
-2,500,176,134,-42,False
-2,293,158,152,-6,False
-2,86,140,142,2,False
-2,385,166,144,-22,False
-2,178,148,150,2,False
-2,477,174,136,-38,False
-2,270,156,154,-2,False
-2,63,138,140,2,False
-2,362,164,146,-18,False
-2,155,146,148,2,False
-2,454,172,138,-34,False
-2,247,154,156,2,False
-2,40,136,138,2,False
-2,339,162,148,-14,False
-2,132,144,146,2,False
-2,431,170,140,-30,False
-2,224,152,154,2,False
-2,17,134,136,2,False
-2,316,160,150,-10,False
-2,109,142,144,2,False
-2,408,168,142,-26,False
-2,201,150,152,2,False
-2,500,176,134,-42,False
-2,293,158,152,-6,False
-2,86,140,142,2,False
-2,385,166,144,-22,False
-2,178,148,150,2,False
-2,477,174,136,-38,False
-2,270,156,154,-2,False
-2,63,138,140,2,False
-2,362,164,146,-18,False
-2,155,146,148,2,False
-2,454,172,138,-34,False
-2,247,154,156,2,False
-2,40,136,138,2,False
-2,339,162,148,-14,False
-2,132,144,146,2,False
-2,431,170,140,-30,False
-2,224,152,154,2,False
-2,17,134,136,2,False
-2,316,160,150,-10,False
-2,109,142,144,2,False
-2,408,168,142,-26,False
-2,201,150,152,2,False
-2,500,176,134,-42,False
-2,293,158,152,-6,False
-2,86,140,142,2,False
-2,385,166,144,-22,False
-2,178,148,150,2,False
-2,477,174,136,-38,False
-2,270,156,154,-2,False
-2,63,138,140,2,False
-2,362,164,146,-18,False
-2,155,146,148,2,False
-2,454,172,138,-34,False
-2,247,154,156,2,False
-2,40,136,138,2,False
-2,339,162,148,-14,False
-2,132,144,146,2,False
-2,431,170,140,-30,False
-2,224,152,154,2,False
-2,17,134,136,2,False
-2,316,160,150,-10,False
-2,109,142,144,2,False
-2,408,168,142,-26,False
-2,201,150,152,2,False
-2,500,176,134,-42,False
-2,293,158,152,-6,False
-2,86,140,142,2,False
-2,385,166,144,-22,False
-2,178,148,150,2,False
-2,477,174,136,-38,False
-2,270,156,154,-2,False
-2,63,138,140,2,False
-2,362,164,146,-18,False
-2,155,146,148,2,False
-2,454,172,138,-34,False
-2,247,154,156,2,False
-2,40,136,138,2,False
-2,339,162,148,-14,False
-2,132,144,146,2,False
-2,431,170,140,-30,False
-2,224,152,154,2,False
-2,17,134,136,2,False
-2,316,160,150,-10,False
-2,109,142,144,2,False
-2,408,168,142,-26,False
-2,201,150,152,2,False
-2,500,176,134,-42,False
-2,293,158,152,-6,False
-2,86,140,142,2,False
-2,385,166,144,-22,False
-2,178,148,150,2,False
-2,477,174,136,-38,False
-2,270,156,154,-2,False
-2,63,138,140,2,False
-2,362,164,146,-18,False
-2,155,146,148,2,False
-2,454,172,138,-34,False
-2,247,154,156,2,False
-2,40,136,138,2,False
-2,339,162,148,-14,False
-2,132,144,146,2,False
-2,431,170,140,-30,False
-2,224,152,154,2,False
-2,17,134,136,2,False
-2,316,160,150,-10,False
-2,109,142,144,2,False
-2,408,168,142,-26,False
-2,201,150,152,2,False
-2,500,176,134,-42,False
-2,293,158,152,-6,False
-2,86,140,142,2,False
-2,385,166,144,-22,False
-2,178,148,150,2,False
-2,477,174,136,-38,False
-2,270,156,154,-2,False
-2,63,138,140,2,False
-2,362,164,146,-18,False
-2,155,146,148,2,False
-2,454,172,138,-34,False
-2,247,154,156,2,False
-2,40,136,138,2,False
-2,339,162,148,-14,False
-2,132,144,146,2,False
-2,431,170,140,-30,False
-2,224,152,154,2,False
-2,17,134,136,2,False
-2,316,160,150,-10,False
-2,109,142,144,2,False
-2,408,168,142,-26,False
-2,201,150,152,2,False
-2,500,176,134,-42,False
-2,293,158,152,-6,False
-2,86,140,142,2,False
-2,385,166,144,-22,False
-2,178,148,150,2,False
-2,477,174,136,-38,False
-2,270,156,154,-2,False
-2,63,138,140,2,False
-2,362,164,146,-18,False
-2,155,146,148,2,False
-2,454,172,138,-34,False
-2,247,154,156,2,False
-2,40,136,138,2,False
-2,339,162,148,-14,False
-2,132,144,146,2,False
-2,431,170,140,-30,False
-2,224,152,154,2,False
-2,17,134,136,2,False
-2,316,160,150,-10,False
-2,109,142,144,2,False
-2,408,168,142,-26,False
-2,201,150,152,2,False
-2,500,176,134,-42,False
-2,293,158,152,-6,False
-2,86,140,142,2,False
-2,385,166,144,-22,False
-2,178,148,150,2,False
-2,477,174,136,-38,False
-2,270,156,154,-2,False
-2,63,138,140,2,False
-2,362,164,146,-18,False
-2,155,146,148,2,False
-2,454,172,138,-34,False
-2,247,154,156,2,False
-2,40,136,138,2,False
-2,339,162,148,-14,False
-2,132,144,146,2,False
-2,431,170,140,-30,False
-2,224,152,154,2,False
-2,17,134,136,2,False
-2,316,160,150,-10,False
-2,109,142,144,2,False
-2,408,168,142,-26,False
-2,201,150,152,2,False
-2,500,176,134,-42,False
-2,293,158,152,-6,False
-2,86,140,142,2,False
-2,385,166,144,-22,False
-2,178,148,150,2,False
-2,477,174,136,-38,False
-2,270,156,154,-2,False
-2,63,138,140,2,False
-2,362,164,146,-18,False
-2,155,146,148,2,False
-2,454,172,138,-34,False
-2,247,154,156,2,False
-2,40,136,138,2,False
-2,339,162,148,-14,False
-2,132,144,146,2,False
-2,431,170,140,-30,False
-2,224,152,154,2,False
-2,17,134,136,2,False
-2,316,160,150,-10,False
-2,109,142,144,2,False
-2,408,168,142,-26,False
-2,201,150,152,2,False
-2,500,176,134,-42,False
-2,293,158,152,-6,False
-2,86,140,142,2,False
-2,385,166,144,-22,False
-2,178,148,150,2,False
-2,477,174,136,-38,False
-2,270,156,154,-2,False
-2,63,138,140,2,False
-2,362,164,146,-18,False
-2,155,146,148,2,False
-2,454,172,138,-34,False
-2,247,154,156,2,False
-2,40,136,138,2,False
-2,339,162,148,-14,False
-2,132,144,146,2,False
-2,431,170,140,-30,False
-2,224,152,154,2,False
-2,17,134,136,2,False
-2,316,160,150,-10,False
-2,109,142,144,2,False
-2,408,168,142,-26,False
-2,201,150,152,2,False
-2,500,176,134,-42,False
-2,293,158,152,-6,False
-2,86,140,142,2,False
-2,385,166,144,-22,False
-2,178,148,150,2,False
-2,477,174,136,-38,False
-2,270,156,154,-2,False
-2,63,138,140,2,False
-2,362,164,146,-18,False
-2,155,146,148,2,False
-2,454,172,138,-34,False
-2,247,154,156,2,False
-2,40,136,138,2,False
-2,339,162,148,-14,False
-2,132,144,146,2,False
-2,431,170,140,-30,False
-2,224,152,154,2,False
-2,17,134,136,2,False
-2,316,160,150,-10,False
-2,109,142,144,2,False
-2,408,168,142,-26,False
-2,201,150,152,2,False
-2,500,176,134,-42,False
-2,293,158,152,-6,False
-2,86,140,142,2,False
-2,385,166,144,-22,False
-2,178,148,150,2,False
-2,477,174,136,-38,False
-2,270,156,154,-2,False
-2,63,138,140,2,False
-2,362,164,146,-18,False
-2,155,146,148,2,False
-2,454,172,138,-34,False
-2,247,154,156,2,False
-2,40,136,138,2,False
-2,339,162,148,-14,False
-2,132,144,146,2,False
-2,431,170,140,-30,False
-2,224,152,154,2,False
-2,17,134,136,2,False
-2,316,160,150,-10,False
-2,109,142,144,2,False
-2,408,168,142,-26,False
-2,201,150,152,2,False
-2,500,176,134,-42,False
-2,293,158,152,-6,False
-2,86,140,142,2,False
-2,385,166,144,-22,False
-2,178,148,150,2,False
-2,477,174,136,-38,False
-2,270,156,154,-2,False
-2,63,138,140,2,False
-2,362,164,146,-18,False
-2,155,146,148,2,False
-2,454,172,138,-34,False
-2,247,154,156,2,False
-2,40,136,138,2,False
-2,339,162,148,-14,False
-2,132,144,146,2,False
-2,431,170,140,-30,False
-2,224,152,154,2,False
-2,17,134,136,2,False
-2,316,160,150,-10,False
-2,109,142,144,2,False
-2,408,168,142,-26,False
-2,201,150,152,2,False
-2,500,176,134,-42,False
-2,293,158,152,-6,False
-2,86,140,142,2,False
-2,385,166,144,-22,False
-2,178,148,150,2,False
-2,477,174,136,-38,False
-2,270,156,154,-2,False
-2,63,138,140,2,False
-2,362,164,146,-18,False
-2,155,146,148,2,False
-2,454,172,138,-34,False
-2,247,154,156,2,False
-2,40,136,138,2,False
-2,339,162,148,-14,False
-2,132,144,146,2,False
-2,431,170,140,-30,False
-2,224,152,154,2,False
-2,17,134,136,2,False
-2,316,160,150,-10,False
-2,109,142,144,2,False
-2,408,168,142,-26,False
-2,201,150,152,2,False
-2,500,176,134,-42,False
-2,293,158,152,-6,False
-2,86,140,142,2,False
-2,385,166,144,-22,False
-2,178,148,150,2,False
-2,477,174,136,-38,False
-2,270,156,154,-2,False
-2,63,138,140,2,False
-2,362,164,146,-18,False
-2,155,146,148,2,False
-2,454,172,138,-34,False
-2,247,154,156,2,False
-2,40,136,138,2,False
-2,339,162,148,-14,False
-2,132,144,146,2,False
-2,431,170,140,-30,False
-2,224,152,154,2,False
-2,17,134,136,2,False
-2,316,160,150,-10,False
-2,109,142,144,2,False
-2,408,168,142,-26,False
-2,201,150,152,2,False
-2,500,176,134,-42,False
-2,293,158,152,-6,False
-2,86,140,142,2,False
-2,385,166,144,-22,False
-2,178,148,150,2,False
-2,477,174,136,-38,False
-2,270,156,154,-2,False
-2,63,138,140,2,False
-2,362,164,146,-18,False
-2,155,146,148,2,False
-2,454,172,138,-34,False
-2,247,154,156,2,False
-2,40,136,138,2,False
-2,339,162,148,-14,False
-2,132,144,146,2,False
-2,431,170,140,-30,False
-2,224,152,154,2,False
-2,17,134,136,2,False
-2,316,160,150,-10,False
-2,109,142,144,2,False
-2,408,168,142,-26,False
-2,201,150,152,2,False
-2,500,176,134,-42,False
-2,293,158,152,-6,False
-2,86,140,142,2,False
-2,385,166,144,-22,False
-2,178,148,150,2,False
-2,477,174,136,-38,False
-2,270,156,154,-2,False
-2,63,138,140,2,False
-2,362,164,146,-18,False
-2,155,146,148,2,False
-2,454,172,138,-34,False
-2,247,154,156,2,False
-2,40,136,138,2,False
-2,339,162,148,-14,False
-2,132,144,146,2,False
-2,431,170,140,-30,False
-2,224,152,154,2,False
-2,17,134,136,2,False
-2,316,160,150,-10,False
-2,109,142,144,2,False
-2,408,168,142,-26,False
-2,201,150,152,2,False
-2,500,176,134,-42,False
-2,293,158,152,-6,False
-2,86,140,142,2,False
-2,385,166,144,-22,False
-2,178,148,150,2,False
-2,477,174,136,-38,False
-2,270,156,154,-2,False
-2,63,138,140,2,False
-2,362,164,146,-18,False
-2,155,146,148,2,False
-2,454,172,138,-34,False
-2,247,154,156,2,False
-2,40,136,138,2,False
-2,339,162,148,-14,False
-2,132,144,146,2,False
-2,431,170,140,-30,False
-2,224,152,154,2,False
-2,17,134,136,2,False
-2,316,160,150,-10,False
-2,109,142,144,2,False
-2,408,168,142,-26,False
-2,201,150,152,2,False
-2,500,176,134,-42,False
-2,293,158,152,-6,False
-2,86,140,142,2,False
-2,385,166,144,-22,False
-2,178,148,150,2,False
-2,477,174,136,-38,False
-2,270,156,154,-2,False
-2,63,138,140,2,False
-2,362,164,146,-18,False
-2,155,146,148,2,False
-2,454,172,138,-34,False
-2,247,154,156,2,False
-2,40,136,138,2,False
-2,339,162,148,-14,False
-2,132,144,146,2,False
-2,431,170,140,-30,False
-2,224,152,154,2,False
-2,17,134,136,2,False
-2,316,160,150,-10,False
-2,109,142,144,2,False
-2,408,168,142,-26,False
-2,201,150,152,2,False
-2,500,176,134,-42,False
-2,293,158,152,-6,False
-2,86,140,142,2,False
-2,385,166,144,-22,False
-2,178,148,150,2,False
-2,477,174,136,-38,False
-2,270,156,154,-2,False
-2,63,138,140,2,False
-2,362,164,146,-18,False
-2,155,146,148,2,False
-2,454,172,138,-34,False
-2,247,154,156,2,False
-2,40,136,138,2,False
-2,339,162,148,-14,False
-2,132,144,146,2,False
-2,431,170,140,-30,False
-2,224,152,154,2,False
-2,17,134,136,2,False
-2,316,160,150,-10,False
-2,109,142,144,2,False
-2,408,168,142,-26,False
-2,201,150,152,2,False
-2,500,176,134,-42,False
-2,293,158,152,-6,False
-2,86,140,142,2,False
-2,385,166,144,-22,False
-2,178,148,150,2,False
-2,477,174,136,-38,False
-2,270,156,154,-2,False
-2,63,138,140,2,False
-2,362,164,146,-18,False
-2,155,146,148,2,False
-2,454,172,138,-34,False
-2,247,154,156,2,False
-2,40,136,138,2,False
-2,339,162,148,-14,False
-2,132,144,146,2,False
-2,431,170,140,-30,False
-2,224,152,154,2,False
-2,17,134,136,2,False
-2,316,160,150,-10,False
-2,109,142,144,2,False
-2,408,168,142,-26,False
-2,201,150,152,2,False
-2,500,176,134,-42,False
-2,293,158,152,-6,False
-2,86,140,142,2,False
-2,385,166,144,-22,False
-2,178,148,150,2,False
-2,477,174,136,-38,False
-2,270,156,154,-2,False
-2,63,138,140,2,False
-2,362,164,146,-18,False
-2,155,146,148,2,False
-2,454,172,138,-34,False
-2,247,154,156,2,False
-2,40,136,138,2,False
-2,339,162,148,-14,False
-2,132,144,146,2,False
-2,431,170,140,-30,False
-2,224,152,154,2,False
-2,17,134,136,2,False
-2,316,160,150,-10,False
-2,109,142,144,2,False
-2,408,168,142,-26,False
-2,201,150,152,2,False
-2,500,176,134,-42,False
-2,293,158,152,-6,False
-2,86,140,142,2,False
-2,385,166,144,-22,False
-2,178,148,150,2,False
-2,477,174,136,-38,False
-2,270,156,154,-2,False
-2,63,138,140,2,False
-2,362,164,146,-18,False
-2,155,146,148,2,False
-2,454,172,138,-34,False
-2,247,154,156,2,False
-2,40,136,138,2,False
-2,339,162,148,-14,False
-2,132,144,146,2,False
-2,431,170,140,-30,False
-2,224,152,154,2,False
-2,17,134,136,2,False
-2,316,160,150,-10,False
-2,109,142,144,2,False
-2,408,168,142,-26,False
-2,201,150,152,2,False
-2,500,176,134,-42,False
-2,293,158,152,-6,False
-2,86,140,142,2,False
-2,385,166,144,-22,False
-2,178,148,150,2,False
-2,477,174,136,-38,False
-2,270,156,154,-2,False
-2,63,138,140,2,False
-2,362,164,146,-18,False
-2,155,146,148,2,False
-2,454,172,138,-34,False
-2,247,154,156,2,False
-2,40,136,138,2,False
-2,339,162,148,-14,False
-2,132,144,146,2,False
-2,431,170,140,-30,False
-2,224,152,154,2,False
-2,17,134,136,2,False
-2,316,160,150,-10,False
-2,109,142,144,2,False
-2,408,168,142,-26,False
-2,201,150,152,2,False
-2,500,176,134,-42,False
-2,293,158,152,-6,False
-2,86,140,142,2,False
-2,385,166,144,-22,False
-2,178,148,150,2,False
-2,477,174,136,-38,False
-2,270,156,154,-2,False
-2,63,138,140,2,False
-2,362,164,146,-18,False
-2,155,146,148,2,False
-2,454,172,138,-34,False
-2,247,154,156,2,False
-2,40,136,138,2,False
-2,339,162,148,-14,False
-2,132,144,146,2,False
-2,431,170,140,-30,False
-2,224,152,154,2,False
-2,17,134,136,2,False
-2,316,160,150,-10,False
-2,109,142,144,2,False
-2,408,168,142,-26,False
-2,201,150,152,2,False
-2,500,176,134,-42,False
-2,293,158,152,-6,False
-2,86,140,142,2,False
-2,385,166,144,-22,False
-2,178,148,150,2,False
-2,477,174,136,-38,False
-2,270,156,154,-2,False
-2,63,138,140,2,False
-2,362,164,146,-18,False
-2,155,146,148,2,False
-2,454,172,138,-34,False
-2,247,154,156,2,False
-2,40,136,138,2,False
-2,339,162,148,-14,False
-2,132,144,146,2,False
-2,431,170,140,-30,False
-2,224,152,154,2,False
-2,17,134,136,2,False
-2,316,160,150,-10,False
-2,109,142,144,2,False
-2,408,168,142,-26,False
-2,201,150,152,2,False
-2,500,176,134,-42,False
-2,293,158,152,-6,False
-2,86,140,142,2,False
-2,385,166,144,-22,False
-2,178,148,150,2,False
-2,477,174,136,-38,False
-2,270,156,154,-2,False
-2,63,138,140,2,False
-2,362,164,146,-18,False
-2,155,146,148,2,False
-2,454,172,138,-34,False
-2,247,154,156,2,False
-2,40,136,138,2,False
-2,339,162,148,-14,False
-2,132,144,146,2,False
-2,431,170,140,-30,False
-2,224,152,154,2,False
-2,17,134,136,2,False
-2,316,160,150,-10,False
-2,109,142,144,2,False
-2,408,168,142,-26,False
-2,201,150,152,2,False
-2,500,176,134,-42,False
-2,293,158,152,-6,False
-2,86,140,142,2,False
-2,385,166,144,-22,False
-2,178,148,150,2,False
-2,477,174,136,-38,False
-2,270,156,154,-2,False
-2,63,138,140,2,False
-2,362,164,146,-18,False
-2,155,146,148,2,False
-2,454,172,138,-34,False
-2,247,154,156,2,False
-2,40,136,138,2,False
-2,339,162,148,-14,False
-2,132,144,146,2,False
-2,431,170,140,-30,False
-2,224,152,154,2,False
-2,17,134,136,2,False
-2,316,160,150,-10,False
-2,109,142,144,2,False
-2,408,168,142,-26,False
-2,201,150,152,2,False
-2,500,176,134,-42,False
-2,293,158,152,-6,False
-2,86,140,142,2,False
-2,385,166,144,-22,False
-2,178,148,150,2,False
-2,477,174,136,-38,False
-2,270,156,154,-2,False
-2,63,138,140,2,False
-2,362,164,146,-18,False
-2,155,146,148,2,False
-2,454,172,138,-34,False
-2,247,154,156,2,False
-2,40,136,138,2,False
-2,339,162,148,-14,False
-2,132,144,146,2,False
-2,431,170,140,-30,False
-2,224,152,154,2,False
-2,17,134,136,2,False
-2,316,160,150,-10,False
-2,109,142,144,2,False
-2,408,168,142,-26,False
-2,201,150,152,2,False
-2,500,176,134,-42,False
-2,293,158,152,-6,False
-2,86,140,142,2,False
-2,385,166,144,-22,False
-2,178,148,150,2,False
-2,477,174,136,-38,False
-2,270,156,154,-2,False
-2,63,138,140,2,False
-2,362,164,146,-18,False
-2,155,146,148,2,False
-2,454,172,138,-34,False
-2,247,154,156,2,False
-2,40,136,138,2,False
-2,339,162,148,-14,False
-2,132,144,146,2,False
-2,431,170,140,-30,False
-2,224,152,154,2,False
-2,17,134,136,2,False
-2,316,160,150,-10,False
-2,109,142,144,2,False
-2,408,168,142,-26,False
-2,201,150,152,2,False
-2,500,176,134,-42,False
-2,293,158,152,-6,False
-2,86,140,142,2,False
-2,385,166,144,-22,False
-2,178,148,150,2,False
-2,477,174,136,-38,False
-2,270,156,154,-2,False
-2,63,138,140,2,False
-2,362,164,146,-18,False
-2,155,146,148,2,False
-2,454,172,138,-34,False
-2,247,154,156,2,False
-2,40,136,138,2,False
-2,339,162,148,-14,False
-2,132,144,146,2,False
-2,431,170,140,-30,False
-2,224,152,154,2,False
-2,17,134,136,2,False
-2,316,160,150,-10,False
-2,109,142,144,2,False
-2,408,168,142,-26,False
-2,201,150,152,2,False
-2,500,176,134,-42,False
-2,293,158,152,-6,False
-2,86,140,142,2,False
-2,385,166,144,-22,False
-2,178,148,150,2,False
-2,477,174,136,-38,False
-2,270,156,154,-2,False
-2,63,138,140,2,False
-2,362,164,146,-18,False
-2,155,146,148,2,False
-2,454,172,138,-34,False
-2,247,154,156,2,False
-2,40,136,138,2,False
-2,339,162,148,-14,False
-2,132,144,146,2,False
-2,431,170,140,-30,False
-2,224,152,154,2,False
-2,17,134,136,2,False
-2,316,160,150,-10,False
-2,109,142,144,2,False
-2,408,168,142,-26,False
-2,201,150,152,2,False
-2,500,176,134,-42,False
-2,293,158,152,-6,False
-2,86,140,142,2,False
-2,385,166,144,-22,False
-2,178,148,150,2,False
-2,477,174,136,-38,False
-2,270,156,154,-2,False
-2,63,138,140,2,False
-2,362,164,146,-18,False
-2,155,146,148,2,False
-2,454,172,138,-34,False
-2,247,154,156,2,False
-2,40,136,138,2,False
-2,339,162,148,-14,False
-2,132,144,146,2,False
-2,431,170,140,-30,False
-2,224,152,154,2,False
-2,17,134,136,2,False
-2,316,160,150,-10,False
-2,109,142,144,2,False
-2,408,168,142,-26,False
-2,201,150,152,2,False
-2,500,176,134,-42,False
-2,293,158,152,-6,False
-2,86,140,142,2,False
-2,385,166,144,-22,False
-2,178,148,150,2,False
-2,477,174,136,-38,False
-2,270,156,154,-2,False
-2,63,138,140,2,False
-2,362,164,146,-18,False
-2,155,146,148,2,False
-2,454,172,138,-34,False
-2,247,154,156,2,False
-2,40,136,138,2,False
-2,339,162,148,-14,False
-2,132,144,146,2,False
-2,431,170,140,-30,False
-2,224,152,154,2,False
-2,17,134,136,2,False
-2,316,160,150,-10,False
-2,109,142,144,2,False
-2,408,168,142,-26,False
-2,201,150,152,2,False
-2,500,176,134,-42,False
-2,293,158,152,-6,False
-2,86,140,142,2,False
-2,385,166,144,-22,False
-2,178,148,150,2,False
-2,477,174,136,-38,False
-2,270,156,154,-2,False
-2,63,138,140,2,False
-2,362,164,146,-18,False
-2,155,146,148,2,False
-2,454,172,138,-34,False
-2,247,154,156,2,False
-2,40,136,138,2,False
-2,339,162,148,-14,False
-2,132,144,146,2,False
-2,431,170,140,-30,False
-2,224,152,154,2,False
-2,17,134,136,2,False
-2,316,160,150,-10,False
-2,109,142,144,2,False
-2,408,168,142,-26,False
-2,201,150,152,2,False
-2,500,176,134,-42,False
-2,293,158,152,-6,False
-2,86,140,142,2,False
-2,385,166,144,-22,False
-2,178,148,150,2,False
-2,477,174,136,-38,False
-2,270,156,154,-2,False
-2,63,138,140,2,False
-2,362,164,146,-18,False
-2,155,146,148,2,False
-2,454,172,138,-34,False
-2,247,154,156,2,False
-2,40,136,138,2,False
-2,339,162,148,-14,False
-2,132,144,146,2,False
-2,431,170,140,-30,False
-2,224,152,154,2,False
-2,17,134,136,2,False
-2,316,160,150,-10,False
-2,109,142,144,2,False
-2,408,168,142,-26,False
-2,201,150,152,2,False
-2,500,176,134,-42,False
-2,293,158,152,-6,False
-2,86,140,142,2,False
-2,385,166,144,-22,False
-2,178,148,150,2,False
-2,477,174,136,-38,False
-2,270,156,154,-2,False
-2,63,138,140,2,False
-2,362,164,146,-18,False
-2,155,146,148,2,False
-2,454,172,138,-34,False
-2,247,154,156,2,False
-2,40,136,138,2,False
-2,339,162,148,-14,False
-2,132,144,146,2,False
-2,431,170,140,-30,False
-2,224,152,154,2,False
-2,17,134,136,2,False
-2,316,160,150,-10,False
-2,109,142,144,2,False
-2,408,168,142,-26,False
-2,201,150,152,2,False
-2,500,176,134,-42,False
-2,293,158,152,-6,False
-2,86,140,142,2,False
-2,385,166,144,-22,False
-2,178,148,150,2,False
-2,477,174,136,-38,False
-2,270,156,154,-2,False
-2,63,138,140,2,False
-2,362,164,146,-18,False
-2,155,146,148,2,False
-2,454,172,138,-34,False
-2,247,154,156,2,False
-2,40,136,138,2,False
-2,339,162,148,-14,False
-2,132,144,146,2,False
-2,431,170,140,-30,False
-2,224,152,154,2,False
-2,17,134,136,2,False
-2,316,160,150,-10,False
-2,109,142,144,2,False
-2,408,168,142,-26,False
-2,201,150,152,2,False
-2,500,176,134,-42,False
-2,293,158,152,-6,False
-2,86,140,142,2,False
-2,385,166,144,-22,False
-2,178,148,150,2,False
-2,477,174,136,-38,False
-2,270,156,154,-2,False
-2,63,138,140,2,False
-2,362,164,146,-18,False
-2,155,146,148,2,False
-2,454,172,138,-34,False
-2,247,154,156,2,False
-2,40,136,138,2,False
-2,339,162,148,-14,False
-2,132,144,146,2,False
-2,431,170,140,-30,False
-2,224,152,154,2,False
-2,17,134,136,2,False
-2,316,160,150,-10,False
-2,109,142,144,2,False
-2,408,168,142,-26,False
-2,201,150,152,2,False
-2,500,176,134,-42,False
-2,293,158,152,-6,False
-2,86,140,142,2,False
-2,385,166,144,-22,False
-2,178,148,150,2,False
-2,477,174,136,-38,False
-2,270,156,154,-2,False
-2,63,138,140,2,False
-2,362,164,146,-18,False
-2,155,146,148,2,False
-2,454,172,138,-34,False
-2,247,154,156,2,False
-2,40,136,138,2,False
-2,339,162,148,-14,False
-2,132,144,146,2,False
-2,431,170,140,-30,False
-2,224,152,154,2,False
-2,17,134,136,2,False
-2,316,160,150,-10,False
-2,109,142,144,2,False
-2,408,168,142,-26,False
-2,201,150,152,2,False
-2,500,176,134,-42,False
-2,293,158,152,-6,False
-2,86,140,142,2,False
-2,385,166,144,-22,False
-2,178,148,150,2,False
-2,477,174,136,-38,False
-2,270,156,154,-2,False
-2,63,138,140,2,False
-2,362,164,146,-18,False
-2,155,146,148,2,False
-2,454,172,138,-34,False
-2,247,154,156,2,False
-2,40,136,138,2,False
-2,339,162,148,-14,False
-2,132,144,146,2,False
-2,431,170,140,-30,False
-2,224,152,154,2,False
-2,17,134,136,2,False
-2,316,160,150,-10,False
-2,109,142,144,2,False
-2,408,168,142,-26,False
-2,201,150,152,2,False
-2,500,176,134,-42,False
-2,293,158,152,-6,False
-2,86,140,142,2,False
-2,385,166,144,-22,False
-2,178,148,150,2,False
-2,477,174,136,-38,False
-2,270,156,154,-2,False
-2,63,138,140,2,False
-2,362,164,146,-18,False
-2,155,146,148,2,False
-2,454,172,138,-34,False
-2,247,154,156,2,False
-2,40,136,138,2,False
-2,339,162,148,-14,False
-2,132,144,146,2,False
-2,431,170,140,-30,False
-2,224,152,154,2,False
-2,17,134,136,2,False
-2,316,160,150,-10,False
-2,109,142,144,2,False
-2,408,168,142,-26,False
-2,201,150,152,2,False
-2,500,176,134,-42,False
-2,293,158,152,-6,False
-2,86,140,142,2,False
-2,385,166,144,-22,False
-2,178,148,150,2,False
-2,477,174,136,-38,False
-2,270,156,154,-2,False
-2,63,138,140,2,False
-2,362,164,146,-18,False
-2,155,146,148,2,False
-2,454,172,138,-34,False
-2,247,154,156,2,False
-2,40,136,138,2,False
-2,339,162,148,-14,False
-2,132,144,146,2,False
-2,431,170,140,-30,False
-2,224,152,154,2,False
-2,17,134,136,2,False
-2,316,160,150,-10,False
-2,109,142,144,2,False
-2,408,168,142,-26,False
-2,201,150,152,2,False
-2,500,176,134,-42,False
-2,293,158,152,-6,False
-2,86,140,142,2,False
-2,385,166,144,-22,False
-2,178,148,150,2,False
-2,477,174,136,-38,False
-2,270,156,154,-2,False
-2,63,138,140,2,False
-2,362,164,146,-18,False
-2,155,146,148,2,False
-2,454,172,138,-34,False
-2,247,154,156,2,False
-2,40,136,138,2,False
-2,339,162,148,-14,False
-2,132,144,146,2,False
-2,431,170,140,-30,False
-2,224,152,154,2,False
-2,17,134,136,2,False
-2,316,160,150,-10,False
-2,109,142,144,2,False
-2,408,168,142,-26,False
-2,201,150,152,2,False
-2,500,176,134,-42,False
-2,293,158,152,-6,False
-2,86,140,142,2,False
-2,385,166,144,-22,False
-2,178,148,150,2,False
-2,477,174,136,-38,False
-2,270,156,154,-2,False
-2,63,138,140,2,False
-2,362,164,146,-18,False
-2,155,146,148,2,False
-2,454,172,138,-34,False
-2,247,154,156,2,False
-2,40,136,138,2,False
-2,339,162,148,-14,False
-2,132,144,146,2,False
-2,431,170,140,-30,False
-2,224,152,154,2,False
-2,17,134,136,2,False
-2,316,160,150,-10,False
-2,109,142,144,2,False
-2,408,168,142,-26,False
-2,201,150,152,2,False
-2,500,176,134,-42,False
-2,293,158,152,-6,False
-2,86,140,142,2,False
-2,385,166,144,-22,False
-2,178,148,150,2,False
-2,477,174,136,-38,False
-2,270,156,154,-2,False
-2,63,138,140,2,False
-2,362,164,146,-18,False
-2,155,146,148,2,False
-2,454,172,138,-34,False
-2,247,154,156,2,False
-2,40,136,138,2,False
-2,339,162,148,-14,False
-2,132,144,146,2,False
-2,431,170,140,-30,False
-2,224,152,154,2,False
-2,17,134,136,2,False
-2,316,160,150,-10,False
-2,109,142,144,2,False
-2,408,168,142,-26,False
-2,201,150,152,2,False
-2,500,176,134,-42,False
-2,293,158,152,-6,False
-2,86,140,142,2,False
-2,385,166,144,-22,False
-2,178,148,150,2,False
-2,477,174,136,-38,False
-2,270,156,154,-2,False
-2,63,138,140,2,False
-2,362,164,146,-18,False
-2,155,146,148,2,False
-2,454,172,138,-34,False
-2,247,154,156,2,False
-2,40,136,138,2,False
-2,339,162,148,-14,False
-2,132,144,146,2,False
-2,431,170,140,-30,False
-2,224,152,154,2,False
-2,17,134,136,2,False
-2,316,160,150,-10,False
-2,109,142,144,2,False
-2,408,168,142,-26,False
-2,201,150,152,2,False
-2,500,176,134,-42,False
-2,293,158,152,-6,False
-2,86,140,142,2,False
-2,385,166,144,-22,False
-2,178,148,150,2,False
-2,477,174,136,-38,False
-2,270,156,154,-2,False
-2,63,138,140,2,False
-2,362,164,146,-18,False
-2,155,146,148,2,False
-2,454,172,138,-34,False
-2,247,154,156,2,False
-2,40,136,138,2,False
-2,339,162,148,-14,False
-2,132,144,146,2,False
-2,431,170,140,-30,False
-2,224,152,154,2,False
-2,17,134,136,2,False
-2,316,160,150,-10,False
-2,109,142,144,2,False
-2,408,168,142,-26,False
-2,201,150,152,2,False
-2,500,176,134,-42,False
-2,293,158,152,-6,False
-2,86,140,142,2,False
-2,385,166,144,-22,False
-2,178,148,150,2,False
-2,477,174,136,-38,False
-2,270,156,154,-2,False
-2,63,138,140,2,False
-2,362,164,146,-18,False
-2,155,146,148,2,False
-2,454,172,138,-34,False
-2,247,154,156,2,False
-2,40,136,138,2,False
-2,339,162,148,-14,False
-2,132,144,146,2,False
-2,431,170,140,-30,False
-2,224,152,154,2,False
-2,17,134,136,2,False
-2,316,160,150,-10,False
-2,109,142,144,2,False
-2,408,168,142,-26,False
-2,201,150,152,2,False
-2,500,176,134,-42,False
-2,293,158,152,-6,False
-2,86,140,142,2,False
-2,385,166,144,-22,False
-2,178,148,150,2,False
-2,477,174,136,-38,False
-2,270,156,154,-2,False
-2,63,138,140,2,False
-2,362,164,146,-18,False
-2,155,146,148,2,False
-2,454,172,138,-34,False
-2,247,154,156,2,False
-2,40,136,138,2,False
-2,339,162,148,-14,False
-2,132,144,146,2,False
-2,431,170,140,-30,False
-2,224,152,154,2,False
-2,17,134,136,2,False
-2,316,160,150,-10,False
-2,109,142,144,2,False
-2,408,168,142,-26,False
-2,201,150,152,2,False
-2,500,176,134,-42,False
-2,293,158,152,-6,False
-2,86,140,142,2,False
-2,385,166,144,-22,False
-2,178,148,150,2,False
-2,477,174,136,-38,False
-2,270,156,154,-2,False
-2,63,138,140,2,False
-2,362,164,146,-18,False
-2,155,146,148,2,False
-2,454,172,138,-34,False
-2,247,154,156,2,False
-2,40,136,138,2,False
-2,339,162,148,-14,False
-2,132,144,146,2,False
-2,431,170,140,-30,False
-2,224,152,154,2,False
-2,17,134,136,2,False
-2,316,160,150,-10,False
-2,109,142,144,2,False
-2,408,168,142,-26,False
-2,201,150,152,2,False
-2,500,176,134,-42,False
-2,293,158,152,-6,False
-2,86,140,142,2,False
-2,385,166,144,-22,False
-2,178,148,150,2,False
-2,477,174,136,-38,False
-2,270,156,154,-2,False
-2,63,138,140,2,False
-2,362,164,146,-18,False
-2,155,146,148,2,False
-2,454,172,138,-34,False
-2,247,154,156,2,False
-2,40,136,138,2,False
-2,339,162,148,-14,False
-2,132,144,146,2,False
-2,431,170,140,-30,False
-2,224,152,154,2,False
-2,17,134,136,2,False
-2,316,160,150,-10,False
-2,109,142,144,2,False
-2,408,168,142,-26,False
-2,201,150,152,2,False
-2,500,176,134,-42,False
-2,293,158,152,-6,False
-2,86,140,142,2,False
-2,385,166,144,-22,False
-2,178,148,150,2,False
-2,477,174,136,-38,False
-2,270,156,154,-2,False
-2,63,138,140,2,False
-2,362,164,146,-18,False
-2,155,146,148,2,False
-2,454,172,138,-34,False
-2,247,154,156,2,False
-2,40,136,138,2,False
-2,339,162,148,-14,False
-2,132,144,146,2,False
-2,431,170,140,-30,False
-2,224,152,154,2,False
-2,17,134,136,2,False
-2,316,160,150,-10,False
-2,109,142,144,2,False
-2,408,168,142,-26,False
-2,201,150,152,2,False
-2,500,176,134,-42,False
-2,293,158,152,-6,False
-2,86,140,142,2,False
-2,385,166,144,-22,False
-2,178,148,150,2,False
-2,477,174,136,-38,False
-2,270,156,154,-2,False
-2,63,138,140,2,False
-2,362,164,146,-18,False
-2,155,146,148,2,False
-2,454,172,138,-34,False
-2,247,154,156,2,False
-2,40,136,138,2,False
-2,339,162,148,-14,False
-2,132,144,146,2,False
-2,431,170,140,-30,False
-2,224,152,154,2,False
-2,17,134,136,2,False
-2,316,160,150,-10,False
-2,109,142,144,2,False
-2,408,168,142,-26,False
-2,201,150,152,2,False
-2,500,176,134,-42,False
-2,293,158,152,-6,False
-2,86,140,142,2,False
-2,385,166,144,-22,False
-2,178,148,150,2,False
-2,477,174,136,-38,False
-2,270,156,154,-2,False
-2,63,138,140,2,False
-2,362,164,146,-18,False
-2,155,146,148,2,False
-2,454,172,138,-34,False
-2,247,154,156,2,False
-2,40,136,138,2,False
-2,339,162,148,-14,False
-2,132,144,146,2,False
-2,431,170,140,-30,False
-2,224,152,154,2,False
-2,17,134,136,2,False
-2,316,160,150,-10,False
-2,109,142,144,2,False
-2,408,168,142,-26,False
-2,201,150,152,2,False
-2,500,176,134,-42,False
-2,293,158,152,-6,False
-2,86,140,142,2,False
-2,385,166,144,-22,False
-2,178,148,150,2,False
-2,477,174,136,-38,False
-2,270,156,154,-2,False
-2,63,138,140,2,False
-2,362,164,146,-18,False
-2,155,146,148,2,False
-2,454,172,138,-34,False
-2,247,154,156,2,False
-2,40,136,138,2,False
-2,339,162,148,-14,False
-2,132,144,146,2,False
-2,431,170,140,-30,False
-2,224,152,154,2,False
-2,17,134,136,2,False
-2,316,160,150,-10,False
-2,109,142,144,2,False
-2,408,168,142,-26,False
-2,201,150,152,2,False
-2,500,176,134,-42,False
-2,293,158,152,-6,False
-2,86,140,142,2,False
-2,385,166,144,-22,False
-2,178,148,150,2,False
-2,477,174,136,-38,False
-2,270,156,154,-2,False
-2,63,138,140,2,False
-2,362,164,146,-18,False
-2,155,146,148,2,False
-2,454,172,138,-34,False
-2,247,154,156,2,False
-2,40,136,138,2,False
-2,339,162,148,-14,False
-2,132,144,146,2,False
-2,431,170,140,-30,False
-2,224,152,154,2,False
-2,17,134,136,2,False
-2,316,160,150,-10,False
-2,109,142,144,2,False
-2,408,168,142,-26,False
-2,201,150,152,2,False
-2,500,176,134,-42,False
-2,293,158,152,-6,False
-2,86,140,142,2,False
-2,385,166,144,-22,False
-2,178,148,150,2,False
-2,477,174,136,-38,False
-2,270,156,154,-2,False
-2,63,138,140,2,False
-2,362,164,146,-18,False
-2,155,146,148,2,False
-2,454,172,138,-34,False
-2,247,154,156,2,False
-2,40,136,138,2,False
-2,339,162,148,-14,False
-2,132,144,146,2,False
-2,431,170,140,-30,False
-2,224,152,154,2,False
-2,17,134,136,2,False
-2,316,160,150,-10,False
-2,109,142,144,2,False
-2,408,168,142,-26,False
-2,201,150,152,2,False
-2,500,176,134,-42,False
-2,293,158,152,-6,False
-2,86,140,142,2,False
-2,385,166,144,-22,False
-2,178,148,150,2,False
-2,477,174,136,-38,False
-2,270,156,154,-2,False
-2,63,138,140,2,False
-2,362,164,146,-18,False
-2,155,146,148,2,False
-2,454,172,138,-34,False
-2,247,154,156,2,False
-2,40,136,138,2,False
-2,339,162,148,-14,False
-2,132,144,146,2,False
-2,431,170,140,-30,False
-2,224,152,154,2,False
-2,17,134,136,2,False
-2,316,160,150,-10,False
-2,109,142,144,2,False
-2,408,168,142,-26,False
-2,201,150,152,2,False
-2,500,176,134,-42,False
-2,293,158,152,-6,False
-2,86,140,142,2,False
-2,385,166,144,-22,False
-2,178,148,150,2,False
-2,477,174,136,-38,False
-2,270,156,154,-2,False
-2,63,138,140,2,False
-2,362,164,146,-18,False
-2,155,146,148,2,False
-2,454,172,138,-34,False
-2,247,154,156,2,False
-2,40,136,138,2,False
-2,339,162,148,-14,False
-2,132,144,146,2,False
-2,431,170,140,-30,False
-2,224,152,154,2,False
-2,17,134,136,2,False
-2,316,160,150,-10,False
-2,109,142,144,2,False
-2,408,168,142,-26,False
-2,201,150,152,2,False
-2,500,176,134,-42,False
-2,293,158,152,-6,False
-2,86,140,142,2,False
-2,385,166,144,-22,False
-2,178,148,150,2,False
-2,477,174,136,-38,False
-2,270,156,154,-2,False
-2,63,138,140,2,False
-2,362,164,146,-18,False
-2,155,146,148,2,False
-2,454,172,138,-34,False
-2,247,154,156,2,False
-2,40,136,138,2,False
-2,339,162,148,-14,False
-2,132,144,146,2,False
-2,431,170,140,-30,False
-2,224,152,154,2,False
-2,17,134,136,2,False
-2,316,160,150,-10,False
-2,109,142,144,2,False
-2,408,168,142,-26,False
-2,201,150,152,2,False
-2,500,176,134,-42,False
-2,293,158,152,-6,False
-2,86,140,142,2,False
-2,385,166,144,-22,False
-2,178,148,150,2,False
-2,477,174,136,-38,False
-2,270,156,154,-2,False
-2,63,138,140,2,False
-2,362,164,146,-18,False
-2,155,146,148,2,False
-2,454,172,138,-34,False
-2,247,154,156,2,False
-2,40,136,138,2,False
-2,339,162,148,-14,False
-2,132,144,146,2,False
-2,431,170,140,-30,False
-2,224,152,154,2,False
-2,17,134,136,2,False
-2,316,160,150,-10,False
-2,109,142,144,2,False
-2,408,168,142,-26,False
-2,201,150,152,2,False
-2,500,176,134,-42,False
-2,293,158,152,-6,False
-2,86,140,142,2,False
-2,385,166,144,-22,False
-2,178,148,150,2,False
-2,477,174,136,-38,False
-2,270,156,154,-2,False
-2,63,138,140,2,False
-2,362,164,146,-18,False
-2,155,146,148,2,False
-2,454,172,138,-34,False
-2,247,154,156,2,False
-2,40,136,138,2,False
-2,339,162,148,-14,False
-2,132,144,146,2,False
-2,431,170,140,-30,False
-2,224,152,154,2,False
-2,17,134,136,2,False
-2,316,160,150,-10,False
-2,109,142,144,2,False
-2,408,168,142,-26,False
-2,201,150,152,2,False
-2,500,176,134,-42,False
-2,293,158,152,-6,False
-2,86,140,142,2,False
-2,385,166,144,-22,False
-2,178,148,150,2,False
-2,477,174,136,-38,False
-2,270,156,154,-2,False
-2,63,138,140,2,False
-2,362,164,146,-18,False
-2,155,146,148,2,False
-2,454,172,138,-34,False
-2,247,154,156,2,False
-2,40,136,138,2,False
-2,339,162,148,-14,False
-2,132,144,146,2,False
-2,431,170,140,-30,False
-2,224,152,154,2,False
-2,17,134,136,2,False
-2,316,160,150,-10,False
-2,109,142,144,2,False
-2,408,168,142,-26,False
-2,201,150,152,2,False
-2,500,176,134,-42,False
-2,293,158,152,-6,False
-2,86,140,142,2,False
-2,385,166,144,-22,False
-2,178,148,150,2,False
-2,477,174,136,-38,False
-2,270,156,154,-2,False
-2,63,138,140,2,False
-2,362,164,146,-18,False
-2,155,146,148,2,False
-2,454,172,138,-34,False
-2,247,154,156,2,False
-2,40,136,138,2,False
-2,339,162,148,-14,False
-2,132,144,146,2,False
-2,431,170,140,-30,False
-2,224,152,154,2,False
-2,17,134,136,2,False
-2,316,160,150,-10,False
-2,109,142,144,2,False
-2,408,168,142,-26,False
-2,201,150,152,2,False
-2,500,176,134,-42,False
-2,293,158,152,-6,False
-2,86,140,142,2,False
-2,385,166,144,-22,False
-2,178,148,150,2,False
-2,477,174,136,-38,False
-2,270,156,154,-2,False
-2,63,138,140,2,False
-2,362,164,146,-18,False
-2,155,146,148,2,False
-2,454,172,138,-34,False
-2,247,154,156,2,False
-2,40,136,138,2,False
-2,339,162,148,-14,False
-2,132,144,146,2,False
-2,431,170,140,-30,False
-2,224,152,154,2,False
-2,17,134,136,2,False
-2,316,160,150,-10,False
-2,109,142,144,2,False
-2,408,168,142,-26,False
-2,201,150,152,2,False
-2,500,176,134,-42,False
-2,293,158,152,-6,False
-2,86,140,142,2,False
-2,385,166,144,-22,False
-2,178,148,150,2,False
-2,477,174,136,-38,False
-2,270,156,154,-2,False
-2,63,138,140,2,False
-2,362,164,146,-18,False
-2,155,146,148,2,False
-2,454,172,138,-34,False
-2,247,154,156,2,False
-2,40,136,138,2,False
-2,339,162,148,-14,False
-2,132,144,146,2,False
-2,431,170,140,-30,False
-2,224,152,154,2,False
-2,17,134,136,2,False
-2,316,160,150,-10,False
-2,109,142,144,2,False
-2,408,168,142,-26,False
-2,201,150,152,2,False
-2,500,176,134,-42,False
-2,293,158,152,-6,False
-2,86,140,142,2,False
-2,385,166,144,-22,False
-2,178,148,150,2,False
-2,477,174,136,-38,False
-2,270,156,154,-2,False
-2,63,138,140,2,False
-2,362,164,146,-18,False
-2,155,146,148,2,False
-2,454,172,138,-34,False
-2,247,154,156,2,False
-2,40,136,138,2,False
-2,339,162,148,-14,False
-2,132,144,146,2,False
-2,431,170,140,-30,False
-2,224,152,154,2,False
-2,17,134,136,2,False
-2,316,160,150,-10,False
-2,109,142,144,2,False
-2,408,168,142,-26,False
-2,201,150,152,2,False
-2,500,176,134,-42,False
-2,293,158,152,-6,False
-2,86,140,142,2,False
-2,385,166,144,-22,False
-2,178,148,150,2,False
-2,477,174,136,-38,False
-2,270,156,154,-2,False
-2,63,138,140,2,False
-2,362,164,146,-18,False
-2,155,146,148,2,False
-2,454,172,138,-34,False
-2,247,154,156,2,False
-2,40,136,138,2,False
-2,339,162,148,-14,False
-2,132,144,146,2,False
-2,431,170,140,-30,False
-2,224,152,154,2,False
-2,17,134,136,2,False
-2,316,160,150,-10,False
-2,109,142,144,2,False
-2,408,168,142,-26,False
-2,201,150,152,2,False
-2,500,176,134,-42,False
-2,293,158,152,-6,False
-2,86,140,142,2,False
-2,385,166,144,-22,False
-2,178,148,150,2,False
-2,477,174,136,-38,False
-2,270,156,154,-2,False
-2,63,138,140,2,False
-2,362,164,146,-18,False
-2,155,146,148,2,False
-2,454,172,138,-34,False
-2,247,154,156,2,False
-2,40,136,138,2,False
-2,339,162,148,-14,False
-2,132,144,146,2,False
-2,431,170,140,-30,False
-2,224,152,154,2,False
-2,17,134,136,2,False
-2,316,160,150,-10,False
-2,109,142,144,2,False
-2,408,168,142,-26,False
-2,201,150,152,2,False
-2,500,176,134,-42,False
-2,293,158,152,-6,False
-2,86,140,142,2,False
-2,385,166,144,-22,False
-2,178,148,150,2,False
-2,477,174,136,-38,False
-2,270,156,154,-2,False
-2,63,138,140,2,False
-2,362,164,146,-18,False
-2,155,146,148,2,False
-2,454,172,138,-34,False
-2,247,154,156,2,False
-2,40,136,138,2,False
-2,339,162,148,-14,False
-2,132,144,146,2,False
-2,431,170,140,-30,False
-2,224,152,154,2,False
-2,17,134,136,2,False
-2,316,160,150,-10,False
-2,109,142,144,2,False
-2,408,168,142,-26,False
-2,201,150,152,2,False
-2,500,176,134,-42,False
-2,293,158,152,-6,False
-2,86,140,142,2,False
-2,385,166,144,-22,False
-2,178,148,150,2,False
-2,477,174,136,-38,False
-2,270,156,154,-2,False
-2,63,138,140,2,False
-2,362,164,146,-18,False
-2,155,146,148,2,False
-2,454,172,138,-34,False
-2,247,154,156,2,False
-2,40,136,138,2,False
-2,339,162,148,-14,False
-2,132,144,146,2,False
-2,431,170,140,-30,False
-2,224,152,154,2,False
-2,17,134,136,2,False
-2,316,160,150,-10,False
-2,109,142,144,2,False
-2,408,168,142,-26,False
-2,201,150,152,2,False
-2,500,176,134,-42,False
-2,293,158,152,-6,False
-2,86,140,142,2,False
-2,385,166,144,-22,False
-2,178,148,150,2,False
-2,477,174,136,-38,False
-2,270,156,154,-2,False
-2,63,138,140,2,False
-2,362,164,146,-18,False
-2,155,146,148,2,False
-2,454,172,138,-34,False
-2,247,154,156,2,False
-2,40,136,138,2,False
-2,339,162,148,-14,False
-2,132,144,146,2,False
-2,431,170,140,-30,False
-2,224,152,154,2,False
-2,17,134,136,2,False
-2,316,160,150,-10,False
-2,109,142,144,2,False
-2,408,168,142,-26,False
-2,201,150,152,2,False
-2,500,176,134,-42,False
-2,293,158,152,-6,False
-2,86,140,142,2,False
-2,385,166,144,-22,False
-2,178,148,150,2,False
-2,477,174,136,-38,False
-2,270,156,154,-2,False
-2,63,138,140,2,False
-2,362,164,146,-18,False
-2,155,146,148,2,False
-2,454,172,138,-34,False
-2,247,154,156,2,False
-2,40,136,138,2,False
-2,339,162,148,-14,False
-2,132,144,146,2,False
-2,431,170,140,-30,False
-2,224,152,154,2,False
-2,17,134,136,2,False
-2,316,160,150,-10,False
-2,109,142,144,2,False
-2,408,168,142,-26,False
-2,201,150,152,2,False
-2,500,176,134,-42,False
-2,293,158,152,-6,False
-2,86,140,142,2,False
-2,385,166,144,-22,False
-2,178,148,150,2,False
-2,477,174,136,-38,False
-2,270,156,154,-2,False
-2,63,138,140,2,False
-2,362,164,146,-18,False
-2,155,146,148,2,False
-2,454,172,138,-34,False
-2,247,154,156,2,False
-2,40,136,138,2,False
-2,339,162,148,-14,False
-2,132,144,146,2,False
-2,431,170,140,-30,False
-2,224,152,154,2,False
-2,17,134,136,2,False
-2,316,160,150,-10,False
-2,109,142,144,2,False
-2,408,168,142,-26,False
-2,201,150,152,2,False
-2,500,176,134,-42,False
-2,293,158,152,-6,False
-2,86,140,142,2,False
-2,385,166,144,-22,False
-2,178,148,150,2,False
-2,477,174,136,-38,False
-2,270,156,154,-2,False
-2,63,138,140,2,False
-2,362,164,146,-18,False
-2,155,146,148,2,False
-2,454,172,138,-34,False
-2,247,154,156,2,False
-2,40,136,138,2,False
-2,339,162,148,-14,False
-2,132,144,146,2,False
-2,431,170,140,-30,False
-2,224,152,154,2,False
-2,17,134,136,2,False
-2,316,160,150,-10,False
-2,109,142,144,2,False
-2,408,168,142,-26,False
-2,201,150,152,2,False
-2,500,176,134,-42,False
-2,293,158,152,-6,False
-2,86,140,142,2,False
-2,385,166,144,-22,False
-2,178,148,150,2,False
-2,477,174,136,-38,False
-2,270,156,154,-2,False
-2,63,138,140,2,False
-2,362,164,146,-18,False
-2,155,146,148,2,False
-2,454,172,138,-34,False
-2,247,154,156,2,False
-2,40,136,138,2,False
-2,339,162,148,-14,False
-2,132,144,146,2,False
-2,431,170,140,-30,False
-2,224,152,154,2,False
-2,17,134,136,2,False
-2,316,160,150,-10,False
-2,109,142,144,2,False
-2,408,168,142,-26,False
-2,201,150,152,2,False
-2,500,176,134,-42,False
-2,293,158,152,-6,False
-2,86,140,142,2,False
-2,385,166,144,-22,False
-2,178,148,150,2,False
-2,477,174,136,-38,False
-2,270,156,154,-2,False
-2,63,138,140,2,False
-2,362,164,146,-18,False
-2,155,146,148,2,False
-2,454,172,138,-34,False
-2,247,154,156,2,False
-2,40,136,138,2,False
-2,339,162,148,-14,False
-2,132,144,146,2,False
-2,431,170,140,-30,False
-2,224,152,154,2,False
-2,17,134,136,2,False
-2,316,160,150,-10,False
-2,109,142,144,2,False
-2,408,168,142,-26,False
-2,201,150,152,2,False
-2,500,176,134,-42,False
-2,293,158,152,-6,False
-2,86,140,142,2,False
-2,385,166,144,-22,False
-2,178,148,150,2,False
-2,477,174,136,-38,False
-2,270,156,154,-2,False
-2,63,138,140,2,False
-2,362,164,146,-18,False
-2,155,146,148,2,False
-2,454,172,138,-34,False
-2,247,154,156,2,False
-2,40,136,138,2,False
-2,339,162,148,-14,False
-2,132,144,146,2,False
-2,431,170,140,-30,False
-2,224,152,154,2,False
-2,17,134,136,2,False
-2,316,160,150,-10,False
-2,109,142,144,2,False
-2,408,168,142,-26,False
-2,201,150,152,2,False
-2,500,176,134,-42,False
-2,293,158,152,-6,False
-2,86,140,142,2,False
-2,385,166,144,-22,False
-2,178,148,150,2,False
-2,477,174,136,-38,False
-2,270,156,154,-2,False
-2,63,138,140,2,False
-2,362,164,146,-18,False
-2,155,146,148,2,False
-2,454,172,138,-34,False
-2,247,154,156,2,False
-2,40,136,138,2,False
-2,339,162,148,-14,False
-2,132,144,146,2,False
-2,431,170,140,-30,False
-2,224,152,154,2,False
-2,17,134,136,2,False
-2,316,160,150,-10,False
-2,109,142,144,2,False
-2,408,168,142,-26,False
-2,201,150,152,2,False
-2,500,176,134,-42,False
-2,293,158,152,-6,False
-2,86,140,142,2,False
-2,385,166,144,-22,False
-2,178,148,150,2,False
-2,477,174,136,-38,False
-2,270,156,154,-2,False
-2,63,138,140,2,False
-2,362,164,146,-18,False
-2,155,146,148,2,False
-2,454,172,138,-34,False
-2,247,154,156,2,False
-2,40,136,138,2,False
-2,339,162,148,-14,False
-2,132,144,146,2,False
-2,431,170,140,-30,False
-2,224,152,154,2,False
-2,17,134,136,2,False
-2,316,160,150,-10,False
-2,109,142,144,2,False
-2,408,168,142,-26,False
-2,201,150,152,2,False
-2,500,176,134,-42,False
-2,293,158,152,-6,False
-2,86,140,142,2,False
-2,385,166,144,-22,False
-2,178,148,150,2,False
-2,477,174,136,-38,False
-2,270,156,154,-2,False
-2,63,138,140,2,False
-2,362,164,146,-18,False
-2,155,146,148,2,False
-2,454,172,138,-34,False
-2,247,154,156,2,False
-2,40,136,138,2,False
-2,339,162,148,-14,False
-2,132,144,146,2,False
-2,431,170,140,-30,False
-2,224,152,154,2,False
-2,17,134,136,2,False
-2,316,160,150,-10,False
-2,109,142,144,2,False
-2,408,168,142,-26,False
-2,201,150,152,2,False
-2,500,176,134,-42,False
-2,293,158,152,-6,False
-2,86,140,142,2,False
-2,385,166,144,-22,False
-2,178,148,150,2,False
-2,477,174,136,-38,False
-2,270,156,154,-2,False
-2,63,138,140,2,False
-2,362,164,146,-18,False
-2,155,146,148,2,False
-2,454,172,138,-34,False
-2,247,154,156,2,False
-2,40,136,138,2,False
-2,339,162,148,-14,False
-2,132,144,146,2,False
-2,431,170,140,-30,False
-2,224,152,154,2,False
-2,17,134,136,2,False
-2,316,160,150,-10,False
-2,109,142,144,2,False
-2,408,168,142,-26,False
-2,201,150,152,2,False
-2,500,176,134,-42,False
-2,293,158,152,-6,False
-2,86,140,142,2,False
-2,385,166,144,-22,False
-2,178,148,150,2,False
-2,477,174,136,-38,False
-2,270,156,154,-2,False
-2,63,138,140,2,False
-2,362,164,146,-18,False
-2,155,146,148,2,False
-2,454,172,138,-34,False
-2,247,154,156,2,False
-2,40,136,138,2,False
-2,339,162,148,-14,False
-2,132,144,146,2,False
-2,431,170,140,-30,False
-2,224,152,154,2,False
-2,17,134,136,2,False
-2,316,160,150,-10,False
-2,109,142,144,2,False
-2,408,168,142,-26,False
-2,201,150,152,2,False
-2,500,176,134,-42,False
-2,293,158,152,-6,False
-2,86,140,142,2,False
-2,385,166,144,-22,False
-2,178,148,150,2,False
-2,477,174,136,-38,False
-2,270,156,154,-2,False
-2,63,138,140,2,False
-2,362,164,146,-18,False
-2,155,146,148,2,False
-2,454,172,138,-34,False
-2,247,154,156,2,False
-2,40,136,138,2,False
-2,339,162,148,-14,False
-2,132,144,146,2,False
-2,431,170,140,-30,False
-2,224,152,154,2,False
-2,17,134,136,2,False
-2,316,160,150,-10,False
-2,109,142,144,2,False
-2,408,168,142,-26,False
-2,201,150,152,2,False
-2,500,176,134,-42,False
-2,293,158,152,-6,False
-2,86,140,142,2,False
-2,385,166,144,-22,False
-2,178,148,150,2,False
-2,477,174,136,-38,False
-2,270,156,154,-2,False
-2,63,138,140,2,False
-2,362,164,146,-18,False
-2,155,146,148,2,False
-2,454,172,138,-34,False
-2,247,154,156,2,False
-2,40,136,138,2,False
-2,339,162,148,-14,False
-2,132,144,146,2,False
-2,431,170,140,-30,False
-2,224,152,154,2,False
-2,17,134,136,2,False
-2,316,160,150,-10,False
-2,109,142,144,2,False
-2,408,168,142,-26,False
-2,201,150,152,2,False
-2,500,176,134,-42,False
-2,293,158,152,-6,False
-2,86,140,142,2,False
-2,385,166,144,-22,False
-2,178,148,150,2,False
-2,477,174,136,-38,False
-2,270,156,154,-2,False
-2,63,138,140,2,False
-2,362,164,146,-18,False
-2,155,146,148,2,False
-2,454,172,138,-34,False
-2,247,154,156,2,False
-2,40,136,138,2,False
-2,339,162,148,-14,False
-2,132,144,146,2,False
-2,431,170,140,-30,False
-2,224,152,154,2,False
-2,17,134,136,2,False
-2,316,160,150,-10,False
-2,109,142,144,2,False
-2,408,168,142,-26,False
-2,201,150,152,2,False
-2,500,176,134,-42,False
-2,293,158,152,-6,False
-2,86,140,142,2,False
-2,385,166,144,-22,False
-2,178,148,150,2,False
-2,477,174,136,-38,False
-2,270,156,154,-2,False
-2,63,138,140,2,False
-2,362,164,146,-18,False
-2,155,146,148,2,False
-2,454,172,138,-34,False
-2,247,154,156,2,False
-2,40,136,138,2,False
-2,339,162,148,-14,False
-2,132,144,146,2,False
-2,431,170,140,-30,False
-2,224,152,154,2,False
-2,17,134,136,2,False
-2,316,160,150,-10,False
-2,109,142,144,2,False
-2,408,168,142,-26,False
-2,201,150,152,2,False
-2,500,176,134,-42,False
-2,293,158,152,-6,False
-2,86,140,142,2,False
-2,385,166,144,-22,False
-2,178,148,150,2,False
-2,477,174,136,-38,False
-2,270,156,154,-2,False
-2,63,138,140,2,False
-2,362,164,146,-18,False
-2,155,146,148,2,False
-2,454,172,138,-34,False
-2,247,154,156,2,False
-2,40,136,138,2,False
-2,339,162,148,-14,False
-2,132,144,146,2,False
-2,431,170,140,-30,False
-2,224,152,154,2,False
-2,17,134,136,2,False
-2,316,160,150,-10,False
-2,109,142,144,2,False
-2,408,168,142,-26,False
-2,201,150,152,2,False
-2,500,176,134,-42,False
-2,293,158,152,-6,False
-2,86,140,142,2,False
-2,385,166,144,-22,False
-2,178,148,150,2,False
-2,477,174,136,-38,False
-2,270,156,154,-2,False
-2,63,138,140,2,False
-2,362,164,146,-18,False
-2,155,146,148,2,False
-2,454,172,138,-34,False
-2,247,154,156,2,False
-2,40,136,138,2,False
-2,339,162,148,-14,False
-2,132,144,146,2,False
-2,431,170,140,-30,False
-2,224,152,154,2,False
-2,17,134,136,2,False
-2,316,160,150,-10,False
-2,109,142,144,2,False
-2,408,168,142,-26,False
-2,201,150,152,2,False
-2,500,176,134,-42,False
-2,293,158,152,-6,False
-2,86,140,142,2,False
-2,385,166,144,-22,False
-2,178,148,150,2,False
-2,477,174,136,-38,False
-2,270,156,154,-2,False
-2,63,138,140,2,False
-2,362,164,146,-18,False
-2,155,146,148,2,False
-2,454,172,138,-34,False
-2,247,154,156,2,False
-2,40,136,138,2,False
-2,339,162,148,-14,False
-2,132,144,146,2,False
-2,431,170,140,-30,False
-2,224,152,154,2,False
-2,17,134,136,2,False
-2,316,160,150,-10,False
-2,109,142,144,2,False
-2,408,168,142,-26,False
-2,201,150,152,2,False
-2,500,176,134,-42,False
-2,293,158,152,-6,False
-2,86,140,142,2,False
-2,385,166,144,-22,False
-2,178,148,150,2,False
-2,477,174,136,-38,False
-2,270,156,154,-2,False
-2,63,138,140,2,False
-2,362,164,146,-18,False
-2,155,146,148,2,False
-2,454,172,138,-34,False
-2,247,154,156,2,False
-2,40,136,138,2,False
-2,339,162,148,-14,False
-2,132,144,146,2,False
-2,431,170,140,-30,False
-2,224,152,154,2,False
-2,17,134,136,2,False
-2,316,160,150,-10,False
-2,109,142,144,2,False
-2,408,168,142,-26,False
-2,201,150,152,2,False
-2,500,176,134,-42,False
-2,293,158,152,-6,False
-2,86,140,142,2,False
-2,385,166,144,-22,False
-2,178,148,150,2,False
-2,477,174,136,-38,False
-2,270,156,154,-2,False
-2,63,138,140,2,False
-2,362,164,146,-18,False
-2,155,146,148,2,False
-2,454,172,138,-34,False
-2,247,154,156,2,False
-2,40,136,138,2,False
-2,339,162,148,-14,False
-2,132,144,146,2,False
-2,431,170,140,-30,False
-2,224,152,154,2,False
-2,17,134,136,2,False
-2,316,160,150,-10,False
-2,109,142,144,2,False
-2,408,168,142,-26,False
-2,201,150,152,2,False
-2,500,176,134,-42,False
-2,293,158,152,-6,False
-2,86,140,142,2,False
-2,385,166,144,-22,False
-2,178,148,150,2,False
-2,477,174,136,-38,False
-2,270,156,154,-2,False
-2,63,138,140,2,False
-2,362,164,146,-18,False
-2,155,146,148,2,False
-2,454,172,138,-34,False
-2,247,154,156,2,False
-2,40,136,138,2,False
-2,339,162,148,-14,False
-2,132,144,146,2,False
-2,431,170,140,-30,False
-2,224,152,154,2,False
-2,17,134,136,2,False
-2,316,160,150,-10,False
-2,109,142,144,2,False
-2,408,168,142,-26,False
-2,201,150,152,2,False
-2,500,176,134,-42,False
-2,293,158,152,-6,False
-2,86,140,142,2,False
-2,385,166,144,-22,False
-2,178,148,150,2,False
-2,477,174,136,-38,False
-2,270,156,154,-2,False
-2,63,138,140,2,False
-2,362,164,146,-18,False
-2,155,146,148,2,False
-2,454,172,138,-34,False
-2,247,154,156,2,False
-2,40,136,138,2,False
-2,339,162,148,-14,False
-2,132,144,146,2,False
-2,431,170,140,-30,False
-2,224,152,154,2,False
-2,17,134,136,2,False
-2,316,160,150,-10,False
-2,109,142,144,2,False
-2,408,168,142,-26,False
-2,201,150,152,2,False
-2,500,176,134,-42,False
-2,293,158,152,-6,False
-2,86,140,142,2,False
-2,385,166,144,-22,False
-2,178,148,150,2,False
-2,477,174,136,-38,False
-2,270,156,154,-2,False
-2,63,138,140,2,False
-2,362,164,146,-18,False
-2,155,146,148,2,False
-2,454,172,138,-34,False
-2,247,154,156,2,False
-2,40,136,138,2,False
-2,339,162,148,-14,False
-2,132,144,146,2,False
-2,431,170,140,-30,False
-2,224,152,154,2,False
-2,17,134,136,2,False
-2,316,160,150,-10,False
-2,109,142,144,2,False
-2,408,168,142,-26,False
-2,201,150,152,2,False
-2,500,176,134,-42,False
-2,293,158,152,-6,False
-2,86,140,142,2,False
-2,385,166,144,-22,False
-2,178,148,150,2,False
-2,477,174,136,-38,False
-2,270,156,154,-2,False
-2,63,138,140,2,False
-2,362,164,146,-18,False
-2,155,146,148,2,False
-2,454,172,138,-34,False
-2,247,154,156,2,False
-2,40,136,138,2,False
-2,339,162,148,-14,False
-2,132,144,146,2,False
-2,431,170,140,-30,False
-2,224,152,154,2,False
-2,17,134,136,2,False
-2,316,160,150,-10,False
-2,109,142,144,2,False
-2,408,168,142,-26,False
-2,201,150,152,2,False
-2,500,176,134,-42,False
-2,293,158,152,-6,False
-2,86,140,142,2,False
-2,385,166,144,-22,False
-2,178,148,150,2,False
-2,477,174,136,-38,False
-2,270,156,154,-2,False
-2,63,138,140,2,False
-2,362,164,146,-18,False
-2,155,146,148,2,False
-2,454,172,138,-34,False
-2,247,154,156,2,False
-2,40,136,138,2,False
-2,339,162,148,-14,False
-2,132,144,146,2,False
-2,431,170,140,-30,False
-2,224,152,154,2,False
-2,17,134,136,2,False
-2,316,160,150,-10,False
-2,109,142,144,2,False
-2,408,168,142,-26,False
-2,201,150,152,2,False
-2,500,176,134,-42,False
-2,293,158,152,-6,False
-2,86,140,142,2,False
-2,385,166,144,-22,False
-2,178,148,150,2,False
-2,477,174,136,-38,False
-2,270,156,154,-2,False
-2,63,138,140,2,False
-2,362,164,146,-18,False
-2,155,146,148,2,False
-2,454,172,138,-34,False
-2,247,154,156,2,False
-2,40,136,138,2,False
-2,339,162,148,-14,False
-2,132,144,146,2,False
-2,431,170,140,-30,False
-2,224,152,154,2,False
-2,17,134,136,2,False
-2,316,160,150,-10,False
-2,109,142,144,2,False
-2,408,168,142,-26,False
-2,201,150,152,2,False
-2,500,176,134,-42,False
-2,293,158,152,-6,False
-2,86,140,142,2,False
-2,385,166,144,-22,False
-2,178,148,150,2,False
-2,477,174,136,-38,False
-2,270,156,154,-2,False
-2,63,138,140,2,False
-2,362,164,146,-18,False
-2,155,146,148,2,False
-2,454,172,138,-34,False
-2,247,154,156,2,False
-2,40,136,138,2,False
-2,339,162,148,-14,False
-2,132,144,146,2,False
-2,431,170,140,-30,False
-2,224,152,154,2,False
-2,17,134,136,2,False
-2,316,160,150,-10,False
-2,109,142,144,2,False
-2,408,168,142,-26,False
-2,201,150,152,2,False
-2,500,176,134,-42,False
-2,293,158,152,-6,False
-2,86,140,142,2,False
-2,385,166,144,-22,False
-2,178,148,150,2,False
-2,477,174,136,-38,False
-2,270,156,154,-2,False
-2,63,138,140,2,False
-2,362,164,146,-18,False
-2,155,146,148,2,False
-2,454,172,138,-34,False
-2,247,154,156,2,False
-2,40,136,138,2,False
-2,339,162,148,-14,False
-2,132,144,146,2,False
-2,431,170,140,-30,False
-2,224,152,154,2,False
-2,17,134,136,2,False
-2,316,160,150,-10,False
-2,109,142,144,2,False
-2,408,168,142,-26,False
-2,201,150,152,2,False
-2,500,176,134,-42,False
-2,293,158,152,-6,False
-2,86,140,142,2,False
-2,385,166,144,-22,False
-2,178,148,150,2,False
-2,477,174,136,-38,False
-2,270,156,154,-2,False
-2,63,138,140,2,False
-2,362,164,146,-18,False
-2,155,146,148,2,False
-2,454,172,138,-34,False
-2,247,154,156,2,False
-2,40,136,138,2,False
-2,339,162,148,-14,False
-2,132,144,146,2,False
-2,431,170,140,-30,False
-2,224,152,154,2,False
-2,17,134,136,2,False
-2,316,160,150,-10,False
-2,109,142,144,2,False
-2,408,168,142,-26,False
-2,201,150,152,2,False
-2,500,176,134,-42,False
-2,293,158,152,-6,False
-2,86,140,142,2,False
-2,385,166,144,-22,False
-2,178,148,150,2,False
-2,477,174,136,-38,False
-2,270,156,154,-2,False
-2,63,138,140,2,False
-2,362,164,146,-18,False
-2,155,146,148,2,False
-2,454,172,138,-34,False
-2,247,154,156,2,False
-2,40,136,138,2,False
-2,339,162,148,-14,False
-2,132,144,146,2,False
-2,431,170,140,-30,False
-2,224,152,154,2,False
-2,17,134,136,2,False
-2,316,160,150,-10,False
-2,109,142,144,2,False
-2,408,168,142,-26,False
-2,201,150,152,2,False
-2,500,176,134,-42,False
-2,293,158,152,-6,False
-2,86,140,142,2,False
-2,385,166,144,-22,False
-2,178,148,150,2,False
-2,477,174,136,-38,False
-2,270,156,154,-2,False
-2,63,138,140,2,False
-2,362,164,146,-18,False
-2,155,146,148,2,False
-2,454,172,138,-34,False
-2,247,154,156,2,False
-2,40,136,138,2,False
-2,339,162,148,-14,False
-2,132,144,146,2,False
-2,431,170,140,-30,False
-2,224,152,154,2,False
-2,17,134,136,2,False
-2,316,160,150,-10,False
-2,109,142,144,2,False
-2,408,168,142,-26,False
-2,201,150,152,2,False
-2,500,176,134,-42,False
-2,293,158,152,-6,False
-2,86,140,142,2,False
-2,385,166,144,-22,False
-2,178,148,150,2,False
-2,477,174,136,-38,False
-2,270,156,154,-2,False
-2,63,138,140,2,False
-2,362,164,146,-18,False
-2,155,146,148,2,False
-2,454,172,138,-34,False
-2,247,154,156,2,False
-2,40,136,138,2,False
-2,339,162,148,-14,False
-2,132,144,146,2,False
-2,431,170,140,-30,False
-2,224,152,154,2,False
-2,17,134,136,2,False
-2,316,160,150,-10,False
-2,109,142,144,2,False
-2,408,168,142,-26,False
-2,201,150,152,2,False
-2,500,176,134,-42,False
-2,293,158,152,-6,False
-2,86,140,142,2,False
-2,385,166,144,-22,False
-2,178,148,150,2,False
-2,477,174,136,-38,False
-2,270,156,154,-2,False
-2,63,138,140,2,False
-2,362,164,146,-18,False
-2,155,146,148,2,False
-2,454,172,138,-34,False
-2,247,154,156,2,False
-2,40,136,138,2,False
-2,339,162,148,-14,False
-2,132,144,146,2,False
-2,431,170,140,-30,False
-2,224,152,154,2,False
-2,17,134,136,2,False
-2,316,160,150,-10,False
-2,109,142,144,2,False
-2,408,168,142,-26,False
-2,201,150,152,2,False
-2,500,176,134,-42,False
-2,293,158,152,-6,False
-2,86,140,142,2,False
-2,385,166,144,-22,False
-2,178,148,150,2,False
-2,477,174,136,-38,False
-2,270,156,154,-2,False
-2,63,138,140,2,False
-2,362,164,146,-18,False
-2,155,146,148,2,False
-2,454,172,138,-34,False
-2,247,154,156,2,False
-2,40,136,138,2,False
-2,339,162,148,-14,False
-2,132,144,146,2,False
-2,431,170,140,-30,False
-2,224,152,154,2,False
-2,17,134,136,2,False
-2,316,160,150,-10,False
-2,109,142,144,2,False
-2,408,168,142,-26,False
-2,201,150,152,2,False
-2,500,176,134,-42,False
-2,293,158,152,-6,False
-2,86,140,142,2,False
-2,385,166,144,-22,False
-2,178,148,150,2,False
-2,477,174,136,-38,False
-2,270,156,154,-2,False
-2,63,138,140,2,False
-2,362,164,146,-18,False
-2,155,146,148,2,False
-2,454,172,138,-34,False
-2,247,154,156,2,False
-2,40,136,138,2,False
-2,339,162,148,-14,False
-2,132,144,146,2,False
-2,431,170,140,-30,False
-2,224,152,154,2,False
-2,17,134,136,2,False
-2,316,160,150,-10,False
-2,109,142,144,2,False
-2,408,168,142,-26,False
-2,201,150,152,2,False
-2,500,176,134,-42,False
-2,293,158,152,-6,False
-2,86,140,142,2,False
-2,385,166,144,-22,False
-2,178,148,150,2,False
-2,477,174,136,-38,False
-2,270,156,154,-2,False
-2,63,138,140,2,False
-2,362,164,146,-18,False
-2,155,146,148,2,False
-2,454,172,138,-34,False
-2,247,154,156,2,False
-2,40,136,138,2,False
-2,339,162,148,-14,False
-2,132,144,146,2,False
-2,431,170,140,-30,False
-2,224,152,154,2,False
-2,17,134,136,2,False
-2,316,160,150,-10,False
-2,109,142,144,2,False
-2,408,168,142,-26,False
-2,201,150,152,2,False
-2,500,176,134,-42,False
-2,293,158,152,-6,False
-2,86,140,142,2,False
-2,385,166,144,-22,False
-2,178,148,150,2,False
-2,477,174,136,-38,False
-2,270,156,154,-2,False
-2,63,138,140,2,False
-2,362,164,146,-18,False
-2,155,146,148,2,False
-2,454,172,138,-34,False
-2,247,154,156,2,False
-2,40,136,138,2,False
-2,339,162,148,-14,False
-2,132,144,146,2,False
-2,431,170,140,-30,False
-2,224,152,154,2,False
-2,17,134,136,2,False
-2,316,160,150,-10,False
-2,109,142,144,2,False
-2,408,168,142,-26,False
-2,201,150,152,2,False
-2,500,176,134,-42,False
-2,293,158,152,-6,False
-2,86,140,142,2,False
-2,385,166,144,-22,False
-2,178,148,150,2,False
-2,477,174,136,-38,False
-2,270,156,154,-2,False
-2,63,138,140,2,False
-2,362,164,146,-18,False
-2,155,146,148,2,False
-2,454,172,138,-34,False
-2,247,154,156,2,False
-2,40,136,138,2,False
-2,339,162,148,-14,False
-2,132,144,146,2,False
-2,431,170,140,-30,False
-2,224,152,154,2,False
-2,17,134,136,2,False
-2,316,160,150,-10,False
-2,109,142,144,2,False
-2,408,168,142,-26,False
-2,201,150,152,2,False
-2,500,176,134,-42,False
-2,293,158,152,-6,False
-2,86,140,142,2,False
-2,385,166,144,-22,False
-2,178,148,150,2,False
-2,477,174,136,-38,False
-2,270,156,154,-2,False
-2,63,138,140,2,False
-2,362,164,146,-18,False
-2,155,146,148,2,False
-2,454,172,138,-34,False
-2,247,154,156,2,False
-2,40,136,138,2,False
-2,339,162,148,-14,False
-2,132,144,146,2,False
-2,431,170,140,-30,False
-2,224,152,154,2,False
-2,17,134,136,2,False
-2,316,160,150,-10,False
-2,109,142,144,2,False
-2,408,168,142,-26,False
-2,201,150,152,2,False
-2,500,176,134,-42,False
-2,293,158,152,-6,False
-2,86,140,142,2,False
-2,385,166,144,-22,False
-2,178,148,150,2,False
-2,477,174,136,-38,False
-2,270,156,154,-2,False
-2,63,138,140,2,False
-2,362,164,146,-18,False
-2,155,146,148,2,False
-2,454,172,138,-34,False
-2,247,154,156,2,False
-2,40,136,138,2,False
-2,339,162,148,-14,False
-2,132,144,146,2,False
-2,431,170,140,-30,False
-2,224,152,154,2,False
-2,17,134,136,2,False
-2,316,160,150,-10,False
-2,109,142,144,2,False
-2,408,168,142,-26,False
-2,201,150,152,2,False
-2,500,176,134,-42,False
-2,293,158,152,-6,False
-2,86,140,142,2,False
-2,385,166,144,-22,False
-2,178,148,150,2,False
-2,477,174,136,-38,False
-2,270,156,154,-2,False
-2,63,138,140,2,False
-2,362,164,146,-18,False
-2,155,146,148,2,False
-2,454,172,138,-34,False
-2,247,154,156,2,False
-2,40,136,138,2,False
-2,339,162,148,-14,False
-2,132,144,146,2,False
-2,431,170,140,-30,False
-2,224,152,154,2,False
-2,17,134,136,2,False
-2,316,160,150,-10,False
-2,109,142,144,2,False
-2,408,168,142,-26,False
-2,201,150,152,2,False
-2,500,176,134,-42,False
-2,293,158,152,-6,False
-2,86,140,142,2,False
-2,385,166,144,-22,False
-2,178,148,150,2,False
-2,477,174,136,-38,False
-2,270,156,154,-2,False
-2,63,138,140,2,False
-2,362,164,146,-18,False
-2,155,146,148,2,False
-2,454,172,138,-34,False
-2,247,154,156,2,False
-2,40,136,138,2,False
-2,339,162,148,-14,False
-2,132,144,146,2,False
-2,431,170,140,-30,False
-2,224,152,154,2,False
-2,17,134,136,2,False
-2,316,160,150,-10,False
-2,109,142,144,2,False
-2,408,168,142,-26,False
-2,201,150,152,2,False
-2,500,176,134,-42,False
-2,293,158,152,-6,False
-2,86,140,142,2,False
-2,385,166,144,-22,False
-2,178,148,150,2,False
-2,477,174,136,-38,False
-2,270,156,154,-2,False
-2,63,138,140,2,False
-2,362,164,146,-18,False
-2,155,146,148,2,False
-2,454,172,138,-34,False
-2,247,154,156,2,False
-2,40,136,138,2,False
-2,339,162,148,-14,False
-2,132,144,146,2,False
-2,431,170,140,-30,False
-2,224,152,154,2,False
-2,17,134,136,2,False
-2,316,160,150,-10,False
-2,109,142,144,2,False
-2,408,168,142,-26,False
-2,201,150,152,2,False
-2,500,176,134,-42,False
-2,293,158,152,-6,False
-2,86,140,142,2,False
-2,385,166,144,-22,False
-2,178,148,150,2,False
-2,477,174,136,-38,False
-2,270,156,154,-2,False
-2,63,138,140,2,False
-2,362,164,146,-18,False
-2,155,146,148,2,False
-2,454,172,138,-34,False
-2,247,154,156,2,False
-2,40,136,138,2,False
-2,339,162,148,-14,False
-2,132,144,146,2,False
-2,431,170,140,-30,False
-2,224,152,154,2,False
-2,17,134,136,2,False
-2,316,160,150,-10,False
-2,109,142,144,2,False
-2,408,168,142,-26,False
-2,201,150,152,2,False
-2,500,176,134,-42,False
-2,293,158,152,-6,False
-2,86,140,142,2,False
-2,385,166,144,-22,False
-2,178,148,150,2,False
-2,477,174,136,-38,False
-2,270,156,154,-2,False
-2,63,138,140,2,False
-2,362,164,146,-18,False
-2,155,146,148,2,False
-2,454,172,138,-34,False
-2,247,154,156,2,False
-2,40,136,138,2,False
-2,339,162,148,-14,False
-2,132,144,146,2,False
-2,431,170,140,-30,False
-2,224,152,154,2,False
-2,17,134,136,2,False
-2,316,160,150,-10,False
-2,109,142,144,2,False
-2,408,168,142,-26,False
-2,201,150,152,2,False
-2,500,176,134,-42,False
-2,293,158,152,-6,False
-2,86,140,142,2,False
-2,385,166,144,-22,False
-2,178,148,150,2,False
-2,477,174,136,-38,False
-2,270,156,154,-2,False
-2,63,138,140,2,False
-2,362,164,146,-18,False
-2,155,146,148,2,False
-2,454,172,138,-34,False
-2,247,154,156,2,False
-2,40,136,138,2,False
-2,339,162,148,-14,False
-2,132,144,146,2,False
-2,431,170,140,-30,False
-2,224,152,154,2,False
-2,17,134,136,2,False
-2,316,160,150,-10,False
-2,109,142,144,2,False
-2,408,168,142,-26,False
-2,201,150,152,2,False
-2,500,176,134,-42,False
-2,293,158,152,-6,False
-2,86,140,142,2,False
-2,385,166,144,-22,False
-2,178,148,150,2,False
-2,477,174,136,-38,False
-2,270,156,154,-2,False
-2,63,138,140,2,False
-2,362,164,146,-18,False
-2,155,146,148,2,False
-2,454,172,138,-34,False
-2,247,154,156,2,False
-2,40,136,138,2,False
-2,339,162,148,-14,False
-2,132,144,146,2,False
-2,431,170,140,-30,False
-2,224,152,154,2,False
-2,17,134,136,2,False
-2,316,160,150,-10,False
-2,109,142,144,2,False
-2,408,168,142,-26,False
-2,201,150,152,2,False
-2,500,176,134,-42,False
-2,293,158,152,-6,False
-2,86,140,142,2,False
-2,385,166,144,-22,False
-2,178,148,150,2,False
-2,477,174,136,-38,False
-2,270,156,154,-2,False
-2,63,138,140,2,False
-2,362,164,146,-18,False
-2,155,146,148,2,False
-2,454,172,138,-34,False
-2,247,154,156,2,False
-2,40,136,138,2,False
-2,339,162,148,-14,False
-2,132,144,146,2,False
-2,431,170,140,-30,False
-2,224,152,154,2,False
-2,17,134,136,2,False
-2,316,160,150,-10,False
-2,109,142,144,2,False
-2,408,168,142,-26,False
-2,201,150,152,2,False
-2,500,176,134,-42,False
-2,293,158,152,-6,False
-2,86,140,142,2,False
-2,385,166,144,-22,False
-2,178,148,150,2,False
-2,477,174,136,-38,False
-2,270,156,154,-2,False
-2,63,138,140,2,False
-2,362,164,146,-18,False
-2,155,146,148,2,False
-2,454,172,138,-34,False
-2,247,154,156,2,False
-2,40,136,138,2,False
-2,339,162,148,-14,False
-2,132,144,146,2,False
-2,431,170,140,-30,False
-2,224,152,154,2,False
-2,17,134,136,2,False
-2,316,160,150,-10,False
-2,109,142,144,2,False
-2,408,168,142,-26,False
-2,201,150,152,2,False
-2,500,176,134,-42,False
-2,293,158,152,-6,False
-2,86,140,142,2,False
-2,385,166,144,-22,False
-2,178,148,150,2,False
-2,477,174,136,-38,False
-2,270,156,154,-2,False
-2,63,138,140,2,False
-2,362,164,146,-18,False
-2,155,146,148,2,False
-2,454,172,138,-34,False
-2,247,154,156,2,False
-2,40,136,138,2,False
-2,339,162,148,-14,False
-2,132,144,146,2,False
-2,431,170,140,-30,False
-2,224,152,154,2,False
-2,17,134,136,2,False
-2,316,160,150,-10,False
-2,109,142,144,2,False
-2,408,168,142,-26,False
-2,201,150,152,2,False
-2,500,176,134,-42,False
-2,293,158,152,-6,False
-2,86,140,142,2,False
-2,385,166,144,-22,False
-2,178,148,150,2,False
-2,477,174,136,-38,False
-2,270,156,154,-2,False
-2,63,138,140,2,False
-2,362,164,146,-18,False
-2,155,146,148,2,False
-2,454,172,138,-34,False
-2,247,154,156,2,False
-2,40,136,138,2,False
-2,339,162,148,-14,False
-2,132,144,146,2,False
-2,431,170,140,-30,False
-2,224,152,154,2,False
-2,17,134,136,2,False
-2,316,160,150,-10,False
-2,109,142,144,2,False
-2,408,168,142,-26,False
-2,201,150,152,2,False
-2,500,176,134,-42,False
-2,293,158,152,-6,False
-2,86,140,142,2,False
-2,385,166,144,-22,False
-2,178,148,150,2,False
-2,477,174,136,-38,False
-2,270,156,154,-2,False
-2,63,138,140,2,False
-2,362,164,146,-18,False
-2,155,146,148,2,False
-2,454,172,138,-34,False
-2,247,154,156,2,False
-2,40,136,138,2,False
-2,339,162,148,-14,False
-2,132,144,146,2,False
-2,431,170,140,-30,False
-2,224,152,154,2,False
-2,17,134,136,2,False
-2,316,160,150,-10,False
-2,109,142,144,2,False
-2,408,168,142,-26,False
-2,201,150,152,2,False
-2,500,176,134,-42,False
-2,293,158,152,-6,False
-2,86,140,142,2,False
-2,385,166,144,-22,False
-2,178,148,150,2,False
-2,477,174,136,-38,False
-2,270,156,154,-2,False
-2,63,138,140,2,False
-2,362,164,146,-18,False
-2,155,146,148,2,False
-2,454,172,138,-34,False
-2,247,154,156,2,False
-2,40,136,138,2,False
-2,339,162,148,-14,False
-2,132,144,146,2,False
-2,431,170,140,-30,False
-2,224,152,154,2,False
-2,17,134,136,2,False
-2,316,160,150,-10,False
-2,109,142,144,2,False
-2,408,168,142,-26,False
-2,201,150,152,2,False
-2,500,176,134,-42,False
-2,293,158,152,-6,False
-2,86,140,142,2,False
-2,385,166,144,-22,False
-2,178,148,150,2,False
-2,477,174,136,-38,False
-2,270,156,154,-2,False
-2,63,138,140,2,False
-2,362,164,146,-18,False
-2,155,146,148,2,False
-2,454,172,138,-34,False
-2,247,154,156,2,False
-2,40,136,138,2,False
-2,339,162,148,-14,False
-2,132,144,146,2,False
-2,431,170,140,-30,False
-2,224,152,154,2,False
-2,17,134,136,2,False
-2,316,160,150,-10,False
-2,109,142,144,2,False
-2,408,168,142,-26,False
-2,201,150,152,2,False
-2,500,176,134,-42,False
-2,293,158,152,-6,False
-2,86,140,142,2,False
-2,385,166,144,-22,False
-2,178,148,150,2,False
-2,477,174,136,-38,False
-2,270,156,154,-2,False
-2,63,138,140,2,False
-2,362,164,146,-18,False
-2,155,146,148,2,False
-2,454,172,138,-34,False
-2,247,154,156,2,False
-2,40,136,138,2,False
-2,339,162,148,-14,False
-2,132,144,146,2,False
-2,431,170,140,-30,False
-2,224,152,154,2,False
-2,17,134,136,2,False
-2,316,160,150,-10,False
-2,109,142,144,2,False
-2,408,168,142,-26,False
-2,201,150,152,2,False
-2,500,176,134,-42,False
-2,293,158,152,-6,False
-2,86,140,142,2,False
-2,385,166,144,-22,False
-2,178,148,150,2,False
-2,477,174,136,-38,False
-2,270,156,154,-2,False
-2,63,138,140,2,False
-2,362,164,146,-18,False
-2,155,146,148,2,False
-2,454,172,138,-34,False
-2,247,154,156,2,False
-2,40,136,138,2,False
-2,339,162,148,-14,False
-2,132,144,146,2,False
-2,431,170,140,-30,False
-2,224,152,154,2,False
-2,17,134,136,2,False
-2,316,160,150,-10,False
-2,109,142,144,2,False
-2,408,168,142,-26,False
-2,201,150,152,2,False
-2,500,176,134,-42,False
-2,293,158,152,-6,False
-2,86,140,142,2,False
-2,385,166,144,-22,False
-2,178,148,150,2,False
-2,477,174,136,-38,False
-2,270,156,154,-2,False
-2,63,138,140,2,False
-2,362,164,146,-18,False
-2,155,146,148,2,False
-2,454,172,138,-34,False
-2,247,154,156,2,False
-2,40,136,138,2,False
-2,339,162,148,-14,False
-2,132,144,146,2,False
-2,431,170,140,-30,False
-2,224,152,154,2,False
-2,17,134,136,2,False
-2,316,160,150,-10,False
-2,109,142,144,2,False
-2,408,168,142,-26,False
-2,201,150,152,2,False
-2,500,176,134,-42,False
-2,293,158,152,-6,False
-2,86,140,142,2,False
-2,385,166,144,-22,False
-2,178,148,150,2,False
-2,477,174,136,-38,False
-2,270,156,154,-2,False
-2,63,138,140,2,False
-2,362,164,146,-18,False
-2,155,146,148,2,False
-2,454,172,138,-34,False
-2,247,154,156,2,False
-2,40,136,138,2,False
-2,339,162,148,-14,False
-2,132,144,146,2,False
-2,431,170,140,-30,False
-2,224,152,154,2,False
-2,17,134,136,2,False
-2,316,160,150,-10,False
-2,109,142,144,2,False
-2,408,168,142,-26,False
-2,201,150,152,2,False
-2,500,176,134,-42,False
-2,293,158,152,-6,False
-2,86,140,142,2,False
-2,385,166,144,-22,False
-2,178,148,150,2,False
-2,477,174,136,-38,False
-2,270,156,154,-2,False
-2,63,138,140,2,False
-2,362,164,146,-18,False
-2,155,146,148,2,False
-2,454,172,138,-34,False
-2,247,154,156,2,False
-2,40,136,138,2,False
-2,339,162,148,-14,False
-2,132,144,146,2,False
-2,431,170,140,-30,False
-2,224,152,154,2,False
-2,17,134,136,2,False
-2,316,160,150,-10,False
-2,109,142,144,2,False
-2,408,168,142,-26,False
-2,201,150,152,2,False
-2,500,176,134,-42,False
-2,293,158,152,-6,False
-2,86,140,142,2,False
-2,385,166,144,-22,False
-2,178,148,150,2,False
-2,477,174,136,-38,False
-2,270,156,154,-2,False
-2,63,138,140,2,False
-2,362,164,146,-18,False
-2,155,146,148,2,False
-2,454,172,138,-34,False
-2,247,154,156,2,False
-2,40,136,138,2,False
-2,339,162,148,-14,False
-2,132,144,146,2,False
-2,431,170,140,-30,False
-2,224,152,154,2,False
-2,17,134,136,2,False
-2,316,160,150,-10,False
-2,109,142,144,2,False
-2,408,168,142,-26,False
-2,201,150,152,2,False
-2,500,176,134,-42,False
-2,293,158,152,-6,False
-2,86,140,142,2,False
-2,385,166,144,-22,False
-2,178,148,150,2,False
-2,477,174,136,-38,False
-2,270,156,154,-2,False
-2,63,138,140,2,False
-2,362,164,146,-18,False
-2,155,146,148,2,False
-2,454,172,138,-34,False
-2,247,154,156,2,False
-2,40,136,138,2,False
-2,339,162,148,-14,False
-2,132,144,146,2,False
-2,431,170,140,-30,False
-2,224,152,154,2,False
-2,17,134,136,2,False
-2,316,160,150,-10,False
-2,109,142,144,2,False
-2,408,168,142,-26,False
-2,201,150,152,2,False
-2,500,176,134,-42,False
-2,293,158,152,-6,False
-2,86,140,142,2,False
-2,385,166,144,-22,False
-2,178,148,150,2,False
-2,477,174,136,-38,False
-2,270,156,154,-2,False
-2,63,138,140,2,False
-2,362,164,146,-18,False
-2,155,146,148,2,False
-2,454,172,138,-34,False
-2,247,154,156,2,False
-2,40,136,138,2,False
-2,339,162,148,-14,False
-2,132,144,146,2,False
-2,431,170,140,-30,False
-2,224,152,154,2,False
-2,17,134,136,2,False
-2,316,160,150,-10,False
-2,109,142,144,2,False
-2,408,168,142,-26,False
-2,201,150,152,2,False
-2,500,176,134,-42,False
-2,293,158,152,-6,False
-2,86,140,142,2,False
-2,385,166,144,-22,False
-2,178,148,150,2,False
-2,477,174,136,-38,False
-2,270,156,154,-2,False
-2,63,138,140,2,False
-2,362,164,146,-18,False
-2,155,146,148,2,False
-2,454,172,138,-34,False
-2,247,154,156,2,False
-2,40,136,138,2,False
-2,339,162,148,-14,False
-2,132,144,146,2,False
-2,431,170,140,-30,False
-2,224,152,154,2,False
-2,17,134,136,2,False
-2,316,160,150,-10,False
-2,109,142,144,2,False
-2,408,168,142,-26,False
-2,201,150,152,2,False
-2,500,176,134,-42,False
-2,293,158,152,-6,False
-2,86,140,142,2,False
-2,385,166,144,-22,False
-2,178,148,150,2,False
-2,477,174,136,-38,False
-2,270,156,154,-2,False
-2,63,138,140,2,False
-2,362,164,146,-18,False
-2,155,146,148,2,False
-2,454,172,138,-34,False
-2,247,154,156,2,False
-2,40,136,138,2,False
-2,339,162,148,-14,False
-2,132,144,146,2,False
-2,431,170,140,-30,False
-2,224,152,154,2,False
-2,17,134,136,2,False
-2,316,160,150,-10,False
-2,109,142,144,2,False
-2,408,168,142,-26,False
-2,201,150,152,2,False
-2,500,176,134,-42,False
-2,293,158,152,-6,False
-2,86,140,142,2,False
-2,385,166,144,-22,False
-2,178,148,150,2,False
-2,477,174,136,-38,False
-2,270,156,154,-2,False
-2,63,138,140,2,False
-2,362,164,146,-18,False
-2,155,146,148,2,False
-2,454,172,138,-34,False
-2,247,154,156,2,False
-2,40,136,138,2,False
-2,339,162,148,-14,False
-2,132,144,146,2,False
-2,431,170,140,-30,False
-2,224,152,154,2,False
-2,17,134,136,2,False
-2,316,160,150,-10,False
-2,109,142,144,2,False
-2,408,168,142,-26,False
-2,201,150,152,2,False
-2,500,176,134,-42,False
-2,293,158,152,-6,False
-2,86,140,142,2,False
-2,385,166,144,-22,False
-2,178,148,150,2,False
-2,477,174,136,-38,False
-2,270,156,154,-2,False
-2,63,138,140,2,False
-2,362,164,146,-18,False
-2,155,146,148,2,False
-2,454,172,138,-34,False
-2,247,154,156,2,False
-2,40,136,138,2,False
-2,339,162,148,-14,False
-2,132,144,146,2,False
-2,431,170,140,-30,False
-2,224,152,154,2,False
-2,17,134,136,2,False
-2,316,160,150,-10,False
-2,109,142,144,2,False
-2,408,168,142,-26,False
-2,201,150,152,2,False
-2,500,176,134,-42,False
-2,293,158,152,-6,False
-2,86,140,142,2,False
-2,385,166,144,-22,False
-2,178,148,150,2,False
-2,477,174,136,-38,False
-2,270,156,154,-2,False
-2,63,138,140,2,False
-2,362,164,146,-18,False
-2,155,146,148,2,False
-2,454,172,138,-34,False
-2,247,154,156,2,False
-2,40,136,138,2,False
-2,339,162,148,-14,False
-2,132,144,146,2,False
-2,431,170,140,-30,False
-2,224,152,154,2,False
-2,17,134,136,2,False
-2,316,160,150,-10,False
-2,109,142,144,2,False
-2,408,168,142,-26,False
-2,201,150,152,2,False
-2,500,176,134,-42,False
-2,293,158,152,-6,False
-2,86,140,142,2,False
-2,385,166,144,-22,False
-2,178,148,150,2,False
-2,477,174,136,-38,False
-2,270,156,154,-2,False
-2,63,138,140,2,False
-2,362,164,146,-18,False
-2,155,146,148,2,False
-2,454,172,138,-34,False
-2,247,154,156,2,False
-2,40,136,138,2,False
-2,339,162,148,-14,False
-2,132,144,146,2,False
-2,431,170,140,-30,False
-2,224,152,154,2,False
-2,17,134,136,2,False
-2,316,160,150,-10,False
-2,109,142,144,2,False
-2,408,168,142,-26,False
-2,201,150,152,2,False
-2,500,176,134,-42,False
-2,293,158,152,-6,False
-2,86,140,142,2,False
-2,385,166,144,-22,False
-2,178,148,150,2,False
-2,477,174,136,-38,False
-2,270,156,154,-2,False
-2,63,138,140,2,False
-2,362,164,146,-18,False
-2,155,146,148,2,False
-2,454,172,138,-34,False
-2,247,154,156,2,False
-2,40,136,138,2,False
-2,339,162,148,-14,False
-2,132,144,146,2,False
-2,431,170,140,-30,False
-2,224,152,154,2,False
-2,17,134,136,2,False
-2,316,160,150,-10,False
-2,109,142,144,2,False
-2,408,168,142,-26,False
-2,201,150,152,2,False
-2,500,176,134,-42,False
-2,293,158,152,-6,False
-2,86,140,142,2,False
-2,385,166,144,-22,False
-2,178,148,150,2,False
-2,477,174,136,-38,False
-2,270,156,154,-2,False
-2,63,138,140,2,False
-2,362,164,146,-18,False
-2,155,146,148,2,False
-2,454,172,138,-34,False
-2,247,154,156,2,False
-2,40,136,138,2,False
-2,339,162,148,-14,False
-2,132,144,146,2,False
-2,431,170,140,-30,False
-2,224,152,154,2,False
-2,17,134,136,2,False
-2,316,160,150,-10,False
-2,109,142,144,2,False
-2,408,168,142,-26,False
-2,201,150,152,2,False
-2,500,176,134,-42,False
-2,293,158,152,-6,False
-2,86,140,142,2,False
-2,385,166,144,-22,False
-2,178,148,150,2,False
-2,477,174,136,-38,False
-2,270,156,154,-2,False
-2,63,138,140,2,False
-2,362,164,146,-18,False
-2,155,146,148,2,False
-2,454,172,138,-34,False
-2,247,154,156,2,False
-2,40,136,138,2,False
-2,339,162,148,-14,False
-2,132,144,146,2,False
-2,431,170,140,-30,False
-2,224,152,154,2,False
-2,17,134,136,2,False
-2,316,160,150,-10,False
-2,109,142,144,2,False
-2,408,168,142,-26,False
-2,201,150,152,2,False
-2,500,176,134,-42,False
-2,293,158,152,-6,False
-2,86,140,142,2,False
-2,385,166,144,-22,False
-2,178,148,150,2,False
-2,477,174,136,-38,False
-2,270,156,154,-2,False
-2,63,138,140,2,False
-2,362,164,146,-18,False
-2,155,146,148,2,False
-2,454,172,138,-34,False
-2,247,154,156,2,False
-2,40,136,138,2,False
-2,339,162,148,-14,False
-2,132,144,146,2,False
-2,431,170,140,-30,False
-2,224,152,154,2,False
-2,17,134,136,2,False
-2,316,160,150,-10,False
-2,109,142,144,2,False
-2,408,168,142,-26,False
-2,201,150,152,2,False
-2,500,176,134,-42,False
-2,293,158,152,-6,False
-2,86,140,142,2,False
-2,385,166,144,-22,False
-2,178,148,150,2,False
-2,477,174,136,-38,False
-2,270,156,154,-2,False
-2,63,138,140,2,False
-2,362,164,146,-18,False
-2,155,146,148,2,False
-2,454,172,138,-34,False
-2,247,154,156,2,False
-2,40,136,138,2,False
-2,339,162,148,-14,False
-2,132,144,146,2,False
-2,431,170,140,-30,False
-2,224,152,154,2,False
-2,17,134,136,2,False
-2,316,160,150,-10,False
-2,109,142,144,2,False
-2,408,168,142,-26,False
-2,201,150,152,2,False
-2,500,176,134,-42,False
-2,293,158,152,-6,False
-2,86,140,142,2,False
-2,385,166,144,-22,False
-2,178,148,150,2,False
-2,477,174,136,-38,False
-2,270,156,154,-2,False
-2,63,138,140,2,False
-2,362,164,146,-18,False
-2,155,146,148,2,False
-2,454,172,138,-34,False
-2,247,154,156,2,False
-2,40,136,138,2,False
-2,339,162,148,-14,False
-2,132,144,146,2,False
-2,431,170,140,-30,False
-2,224,152,154,2,False
-2,17,134,136,2,False
-2,316,160,150,-10,False
-2,109,142,144,2,False
-2,408,168,142,-26,False
-2,201,150,152,2,False
-2,500,176,134,-42,False
-2,293,158,152,-6,False
-2,86,140,142,2,False
-2,385,166,144,-22,False
-2,178,148,150,2,False
-2,477,174,136,-38,False
-2,270,156,154,-2,False
-2,63,138,140,2,False
-2,362,164,146,-18,False
-2,155,146,148,2,False
-2,454,172,138,-34,False
-2,247,154,156,2,False
-2,40,136,138,2,False
-2,339,162,148,-14,False
-2,132,144,146,2,False
-2,431,170,140,-30,False
-2,224,152,154,2,False
-2,17,134,136,2,False
-2,316,160,150,-10,False
-2,109,142,144,2,False
-2,408,168,142,-26,False
-2,201,150,152,2,False
-2,500,176,134,-42,False
-2,293,158,152,-6,False
-2,86,140,142,2,False
-2,385,166,144,-22,False
-2,178,148,150,2,False
-2,477,174,136,-38,False
-2,270,156,154,-2,False
-2,63,138,140,2,False
-2,362,164,146,-18,False
-2,155,146,148,2,False
-2,454,172,138,-34,False
-2,247,154,156,2,False
-2,40,136,138,2,False
-2,339,162,148,-14,False
-2,132,144,146,2,False
-2,431,170,140,-30,False
-2,224,152,154,2,False
-2,17,134,136,2,False
-2,316,160,150,-10,False
-2,109,142,144,2,False
-2,408,168,142,-26,False
-2,201,150,152,2,False
-2,500,176,134,-42,False
-2,293,158,152,-6,False
-2,86,140,142,2,False
-2,385,166,144,-22,False
-2,178,148,150,2,False
-2,477,174,136,-38,False
-2,270,156,154,-2,False
-2,63,138,140,2,False
-2,362,164,146,-18,False
-2,155,146,148,2,False
-2,454,172,138,-34,False
-2,247,154,156,2,False
-2,40,136,138,2,False
-2,339,162,148,-14,False
-2,132,144,146,2,False
-2,431,170,140,-30,False
-2,224,152,154,2,False
-2,17,134,136,2,False
-2,316,160,150,-10,False
-2,109,142,144,2,False
-2,408,168,142,-26,False
-2,201,150,152,2,False
-2,500,176,134,-42,False
-2,293,158,152,-6,False
-2,86,140,142,2,False
-2,385,166,144,-22,False
-2,178,148,150,2,False
-2,477,174,136,-38,False
-2,270,156,154,-2,False
-2,63,138,140,2,False
-2,362,164,146,-18,False
-2,155,146,148,2,False
-2,454,172,138,-34,False
-2,247,154,156,2,False
-2,40,136,138,2,False
-2,339,162,148,-14,False
-2,132,144,146,2,False
-2,431,170,140,-30,False
-2,224,152,154,2,False
-2,17,134,136,2,False
-2,316,160,150,-10,False
-2,109,142,144,2,False
-2,408,168,142,-26,False
-2,201,150,152,2,False
-2,500,176,134,-42,False
-2,293,158,152,-6,False
-2,86,140,142,2,False
-2,385,166,144,-22,False
-2,178,148,150,2,False
-2,477,174,136,-38,False
-2,270,156,154,-2,False
-2,63,138,140,2,False
-2,362,164,146,-18,False
-2,155,146,148,2,False
-2,454,172,138,-34,False
-2,247,154,156,2,False
-2,40,136,138,2,False
-2,339,162,148,-14,False
-2,132,144,146,2,False
-2,431,170,140,-30,False
-2,224,152,154,2,False
-2,17,134,136,2,False
-2,316,160,150,-10,False
-2,109,142,144,2,False
-2,408,168,142,-26,False
-2,201,150,152,2,False
-2,500,176,134,-42,False
-2,293,158,152,-6,False
-2,86,140,142,2,False
-2,385,166,144,-22,False
-2,178,148,150,2,False
-2,477,174,136,-38,False
-2,270,156,154,-2,False
-2,63,138,140,2,False
-2,362,164,146,-18,False
-2,155,146,148,2,False
-2,454,172,138,-34,False
-2,247,154,156,2,False
-2,40,136,138,2,False
-2,339,162,148,-14,False
-2,132,144,146,2,False
-2,431,170,140,-30,False
-2,224,152,154,2,False
-2,17,134,136,2,False
-2,316,160,150,-10,False
-2,109,142,144,2,False
-2,408,168,142,-26,False
-2,201,150,152,2,False
-2,500,176,134,-42,False
-2,293,158,152,-6,False
-2,86,140,142,2,False
-2,385,166,144,-22,False
-2,178,148,150,2,False
-2,477,174,136,-38,False
-2,270,156,154,-2,False
-2,63,138,140,2,False
-2,362,164,146,-18,False
-2,155,146,148,2,False
-2,454,172,138,-34,False
-2,247,154,156,2,False
-2,40,136,138,2,False
-2,339,162,148,-14,False
-2,132,144,146,2,False
-2,431,170,140,-30,False
-2,224,152,154,2,False
-2,17,134,136,2,False
-2,316,160,150,-10,False
-2,109,142,144,2,False
-2,408,168,142,-26,False
-2,201,150,152,2,False
-2,500,176,134,-42,False
-2,293,158,152,-6,False
-2,86,140,142,2,False
-2,385,166,144,-22,False
-2,178,148,150,2,False
-2,477,174,136,-38,False
-2,270,156,154,-2,False
-2,63,138,140,2,False
-2,362,164,146,-18,False
-2,155,146,148,2,False
-2,454,172,138,-34,False
-2,247,154,156,2,False
-2,40,136,138,2,False
-2,339,162,148,-14,False
-2,132,144,146,2,False
-2,431,170,140,-30,False
-2,224,152,154,2,False
-2,17,134,136,2,False
-2,316,160,150,-10,False
-2,109,142,144,2,False
-2,408,168,142,-26,False
-2,201,150,152,2,False
-2,500,176,134,-42,False
-2,293,158,152,-6,False
-2,86,140,142,2,False
-2,385,166,144,-22,False
-2,178,148,150,2,False
-2,477,174,136,-38,False
-2,270,156,154,-2,False
-2,63,138,140,2,False
-2,362,164,146,-18,False
-2,155,146,148,2,False
-2,454,172,138,-34,False
-2,247,154,156,2,False
-2,40,136,138,2,False
-2,339,162,148,-14,False
-2,132,144,146,2,False
-2,431,170,140,-30,False
-2,224,152,154,2,False
-2,17,134,136,2,False
-2,316,160,150,-10,False
-2,109,142,144,2,False
-2,408,168,142,-26,False
-2,201,150,152,2,False
-2,500,176,134,-42,False
-2,293,158,152,-6,False
-2,86,140,142,2,False
-2,385,166,144,-22,False
-2,178,148,150,2,False
-2,477,174,136,-38,False
-2,270,156,154,-2,False
-2,63,138,140,2,False
-2,362,164,146,-18,False
-2,155,146,148,2,False
-2,454,172,138,-34,False
-2,247,154,156,2,False
-2,40,136,138,2,False
-2,339,162,148,-14,False
-2,132,144,146,2,False
-2,431,170,140,-30,False
-2,224,152,154,2,False
-2,17,134,136,2,False
-2,316,160,150,-10,False
-2,109,142,144,2,False
-2,408,168,142,-26,False
-2,201,150,152,2,False
-2,500,176,134,-42,False
-2,293,158,152,-6,False
-2,86,140,142,2,False
-2,385,166,144,-22,False
-2,178,148,150,2,False
-2,477,174,136,-38,False
-2,270,156,154,-2,False
-2,63,138,140,2,False
-2,362,164,146,-18,False
-2,155,146,148,2,False
-2,454,172,138,-34,False
-2,247,154,156,2,False
-2,40,136,138,2,False
-2,339,162,148,-14,False
-2,132,144,146,2,False
-2,431,170,140,-30,False
-2,224,152,154,2,False
-2,17,134,136,2,False
-2,316,160,150,-10,False
-2,109,142,144,2,False
-2,408,168,142,-26,False
-2,201,150,152,2,False
-2,500,176,134,-42,False
-2,293,158,152,-6,False
-2,86,140,142,2,False
-2,385,166,144,-22,False
-2,178,148,150,2,False
-2,477,174,136,-38,False
-2,270,156,154,-2,False
-2,63,138,140,2,False
-2,362,164,146,-18,False
-2,155,146,148,2,False
-2,454,172,138,-34,False
-2,247,154,156,2,False
-2,40,136,138,2,False
-2,339,162,148,-14,False
-2,132,144,146,2,False
-2,431,170,140,-30,False
-2,224,152,154,2,False
-2,17,134,136,2,False
-2,316,160,150,-10,False
-2,109,142,144,2,False
-2,408,168,142,-26,False
-2,201,150,152,2,False
-2,500,176,134,-42,False
-2,293,158,152,-6,False
-2,86,140,142,2,False
-2,385,166,144,-22,False
-2,178,148,150,2,False
-2,477,174,136,-38,False
-2,270,156,154,-2,False
-2,63,138,140,2,False
-2,362,164,146,-18,False
-2,155,146,148,2,False
-2,454,172,138,-34,False
-2,247,154,156,2,False
-2,40,136,138,2,False
-2,339,162,148,-14,False
-2,132,144,146,2,False
-2,431,170,140,-30,False
-2,224,152,154,2,False
-2,17,134,136,2,False
-2,316,160,150,-10,False
-2,109,142,144,2,False
-2,408,168,142,-26,False
-2,201,150,152,2,False
-2,500,176,134,-42,False
-2,293,158,152,-6,False
-2,86,140,142,2,False
-2,385,166,144,-22,False
-2,178,148,150,2,False
-2,477,174,136,-38,False
-2,270,156,154,-2,False
-2,63,138,140,2,False
-2,362,164,146,-18,False
-2,155,146,148,2,False
-2,454,172,138,-34,False
-2,247,154,156,2,False
-2,40,136,138,2,False
-2,339,162,148,-14,False
-2,132,144,146,2,False
-2,431,170,140,-30,False
-2,224,152,154,2,False
-2,17,134,136,2,False
-2,316,160,150,-10,False
-2,109,142,144,2,False
-2,408,168,142,-26,False
-2,201,150,152,2,False
-2,500,176,134,-42,False
-2,293,158,152,-6,False
-2,86,140,142,2,False
-2,385,166,144,-22,False
-2,178,148,150,2,False
-2,477,174,136,-38,False
-2,270,156,154,-2,False
-2,63,138,140,2,False
-2,362,164,146,-18,False
-2,155,146,148,2,False
-2,454,172,138,-34,False
-2,247,154,156,2,False
-2,40,136,138,2,False
-2,339,162,148,-14,False
-2,132,144,146,2,False
-2,431,170,140,-30,False
-2,224,152,154,2,False
-2,17,134,136,2,False
-2,316,160,150,-10,False
-2,109,142,144,2,False
-2,408,168,142,-26,False
-2,201,150,152,2,False
-2,500,176,134,-42,False
-2,293,158,152,-6,False
-2,86,140,142,2,False
-2,385,166,144,-22,False
-2,178,148,150,2,False
-2,477,174,136,-38,False
-2,270,156,154,-2,False
-2,63,138,140,2,False
-2,362,164,146,-18,False
-2,155,146,148,2,False
-2,454,172,138,-34,False
-2,247,154,156,2,False
-2,40,136,138,2,False
-2,339,162,148,-14,False
-2,132,144,146,2,False
-2,431,170,140,-30,False
-2,224,152,154,2,False
-2,17,134,136,2,False
-2,316,160,150,-10,False
-2,109,142,144,2,False
-2,408,168,142,-26,False
-2,201,150,152,2,False
-2,500,176,134,-42,False
-2,293,158,152,-6,False
-2,86,140,142,2,False
-2,385,166,144,-22,False
-2,178,148,150,2,False
-2,477,174,136,-38,False
-2,270,156,154,-2,False
-2,63,138,140,2,False
-2,362,164,146,-18,False
-2,155,146,148,2,False
-2,454,172,138,-34,False
-2,247,154,156,2,False
-2,40,136,138,2,False
-2,339,162,148,-14,False
-2,132,144,146,2,False
-2,431,170,140,-30,False
-2,224,152,154,2,False
-2,17,134,136,2,False
-2,316,160,150,-10,False
-2,109,142,144,2,False
-2,408,168,142,-26,False
-2,201,150,152,2,False
-2,500,176,134,-42,False
-2,293,158,152,-6,False
-2,86,140,142,2,False
-2,385,166,144,-22,False
-2,178,148,150,2,False
-2,477,174,136,-38,False
-2,270,156,154,-2,False
-2,63,138,140,2,False
-2,362,164,146,-18,False
-2,155,146,148,2,False
-2,454,172,138,-34,False
-2,247,154,156,2,False
-2,40,136,138,2,False
-2,339,162,148,-14,False
-2,132,144,146,2,False
-2,431,170,140,-30,False
-2,224,152,154,2,False
-2,17,134,136,2,False
-2,316,160,150,-10,False
-2,109,142,144,2,False
-2,408,168,142,-26,False
-2,201,150,152,2,False
-2,500,176,134,-42,False
-2,293,158,152,-6,False
-2,86,140,142,2,False
-2,385,166,144,-22,False
-2,178,148,150,2,False
-2,477,174,136,-38,False
-2,270,156,154,-2,False
-2,63,138,140,2,False
-2,362,164,146,-18,False
-2,155,146,148,2,False
-2,454,172,138,-34,False
-2,247,154,156,2,False
-2,40,136,138,2,False
-2,339,162,148,-14,False
-2,132,144,146,2,False
-2,431,170,140,-30,False
-2,224,152,154,2,False
-2,17,134,136,2,False
-2,316,160,150,-10,False
-2,109,142,144,2,False
-2,408,168,142,-26,False
-2,201,150,152,2,False
-2,500,176,134,-42,False
-2,293,158,152,-6,False
-2,86,140,142,2,False
-2,385,166,144,-22,False
-2,178,148,150,2,False
-2,477,174,136,-38,False
-2,270,156,154,-2,False
-2,63,138,140,2,False
-2,362,164,146,-18,False
-2,155,146,148,2,False
-2,454,172,138,-34,False
-2,247,154,156,2,False
-2,40,136,138,2,False
-2,339,162,148,-14,False
-2,132,144,146,2,False
-2,431,170,140,-30,False
-2,224,152,154,2,False
-2,17,134,136,2,False
-2,316,160,150,-10,False
-2,109,142,144,2,False
-2,408,168,142,-26,False
-2,201,150,152,2,False
-2,500,176,134,-42,False
-2,293,158,152,-6,False
-2,86,140,142,2,False
-2,385,166,144,-22,False
-2,178,148,150,2,False
-2,477,174,136,-38,False
-2,270,156,154,-2,False
-2,63,138,140,2,False
-2,362,164,146,-18,False
-2,155,146,148,2,False
-2,454,172,138,-34,False
-2,247,154,156,2,False
-2,40,136,138,2,False
-2,339,162,148,-14,False
-2,132,144,146,2,False
-2,431,170,140,-30,False
-2,224,152,154,2,False
-2,17,134,136,2,False
-2,316,160,150,-10,False
-2,109,142,144,2,False
-2,408,168,142,-26,False
-2,201,150,152,2,False
-2,500,176,134,-42,False
-2,293,158,152,-6,False
-2,86,140,142,2,False
-2,385,166,144,-22,False
-2,178,148,150,2,False
-2,477,174,136,-38,False
-2,270,156,154,-2,False
-2,63,138,140,2,False
-2,362,164,146,-18,False
-2,155,146,148,2,False
-2,454,172,138,-34,False
-2,247,154,156,2,False
-2,40,136,138,2,False
-2,339,162,148,-14,False
-2,132,144,146,2,False
-2,431,170,140,-30,False
-2,224,152,154,2,False
-2,17,134,136,2,False
-2,316,160,150,-10,False
-2,109,142,144,2,False
-2,408,168,142,-26,False
-2,201,150,152,2,False
-2,500,176,134,-42,False
-2,293,158,152,-6,False
-2,86,140,142,2,False
-2,385,166,144,-22,False
-2,178,148,150,2,False
-2,477,174,136,-38,False
-2,270,156,154,-2,False
-2,63,138,140,2,False
-2,362,164,146,-18,False
-2,155,146,148,2,False
-2,454,172,138,-34,False
-2,247,154,156,2,False
-2,40,136,138,2,False
-2,339,162,148,-14,False
-2,132,144,146,2,False
-2,431,170,140,-30,False
-2,224,152,154,2,False
-2,17,134,136,2,False
-2,316,160,150,-10,False
-2,109,142,144,2,False
-2,408,168,142,-26,False
-2,201,150,152,2,False
-2,500,176,134,-42,False
-2,293,158,152,-6,False
-2,86,140,142,2,False
-2,385,166,144,-22,False
-2,178,148,150,2,False
-2,477,174,136,-38,False
-2,270,156,154,-2,False
-2,63,138,140,2,False
-2,362,164,146,-18,False
-2,155,146,148,2,False
-2,454,172,138,-34,False
-2,247,154,156,2,False
-2,40,136,138,2,False
-2,339,162,148,-14,False
-2,132,144,146,2,False
-2,431,170,140,-30,False
-2,224,152,154,2,False
-2,17,134,136,2,False
-2,316,160,150,-10,False
-2,109,142,144,2,False
-2,408,168,142,-26,False
-2,201,150,152,2,False
-2,500,176,134,-42,False
-2,293,158,152,-6,False
-2,86,140,142,2,False
-2,385,166,144,-22,False
-2,178,148,150,2,False
-2,477,174,136,-38,False
-2,270,156,154,-2,False
-2,63,138,140,2,False
-2,362,164,146,-18,False
-2,155,146,148,2,False
-2,454,172,138,-34,False
-2,247,154,156,2,False
-2,40,136,138,2,False
-2,339,162,148,-14,False
-2,132,144,146,2,False
-2,431,170,140,-30,False
-2,224,152,154,2,False
-2,17,134,136,2,False
-2,316,160,150,-10,False
-2,109,142,144,2,False
-2,408,168,142,-26,False
-2,201,150,152,2,False
-2,500,176,134,-42,False
-2,293,158,152,-6,False
-2,86,140,142,2,False
-2,385,166,144,-22,False
-2,178,148,150,2,False
-2,477,174,136,-38,False
-2,270,156,154,-2,False
-2,63,138,140,2,False
-2,362,164,146,-18,False
-2,155,146,148,2,False
-2,454,172,138,-34,False
-2,247,154,156,2,False
-2,40,136,138,2,False
-2,339,162,148,-14,False
-2,132,144,146,2,False
-2,431,170,140,-30,False
-2,224,152,154,2,False
-2,17,134,136,2,False
-2,316,160,150,-10,False
-2,109,142,144,2,False
-2,408,168,142,-26,False
-2,201,150,152,2,False
-2,500,176,134,-42,False
-2,293,158,152,-6,False
-2,86,140,142,2,False
-2,385,166,144,-22,False
-2,178,148,150,2,False
-2,477,174,136,-38,False
-2,270,156,154,-2,False
-2,63,138,140,2,False
-2,362,164,146,-18,False
-2,155,146,148,2,False
-2,454,172,138,-34,False
-2,247,154,156,2,False
-2,40,136,138,2,False
-2,339,162,148,-14,False
-2,132,144,146,2,False
-2,431,170,140,-30,False
-2,224,152,154,2,False
-2,17,134,136,2,False
-2,316,160,150,-10,False
-2,109,142,144,2,False
-2,408,168,142,-26,False
-2,201,150,152,2,False
-2,500,176,134,-42,False
-2,293,158,152,-6,False
-2,86,140,142,2,False
-2,385,166,144,-22,False
-2,178,148,150,2,False
-2,477,174,136,-38,False
-2,270,156,154,-2,False
-2,63,138,140,2,False
-2,362,164,146,-18,False
-2,155,146,148,2,False
-2,454,172,138,-34,False
-2,247,154,156,2,False
-2,40,136,138,2,False
-2,339,162,148,-14,False
-2,132,144,146,2,False
-2,431,170,140,-30,False
-2,224,152,154,2,False
-2,17,134,136,2,False
-2,316,160,150,-10,False
-2,109,142,144,2,False
-2,408,168,142,-26,False
-2,201,150,152,2,False
-2,500,176,134,-42,False
-2,293,158,152,-6,False
-2,86,140,142,2,False
-2,385,166,144,-22,False
-2,178,148,150,2,False
-2,477,174,136,-38,False
-2,270,156,154,-2,False
-2,63,138,140,2,False
-2,362,164,146,-18,False
-2,155,146,148,2,False
-2,454,172,138,-34,False
-2,247,154,156,2,False
-2,40,136,138,2,False
-2,339,162,148,-14,False
-2,132,144,146,2,False
-2,431,170,140,-30,False
-2,224,152,154,2,False
-2,17,134,136,2,False
-2,316,160,150,-10,False
-2,109,142,144,2,False
-2,408,168,142,-26,False
-2,201,150,152,2,False
-2,500,176,134,-42,False
-2,293,158,152,-6,False
-2,86,140,142,2,False
-2,385,166,144,-22,False
-2,178,148,150,2,False
-2,477,174,136,-38,False
-2,270,156,154,-2,False
-2,63,138,140,2,False
-2,362,164,146,-18,False
-2,155,146,148,2,False
-2,454,172,138,-34,False
-2,247,154,156,2,False
-2,40,136,138,2,False
-2,339,162,148,-14,False
-2,132,144,146,2,False
-2,431,170,140,-30,False
-2,224,152,154,2,False
-2,17,134,136,2,False
-2,316,160,150,-10,False
-2,109,142,144,2,False
-2,408,168,142,-26,False
-2,201,150,152,2,False
-2,500,176,134,-42,False
-2,293,158,152,-6,False
-2,86,140,142,2,False
-2,385,166,144,-22,False
-2,178,148,150,2,False
-2,477,174,136,-38,False
-2,270,156,154,-2,False
-2,63,138,140,2,False
-2,362,164,146,-18,False
-2,155,146,148,2,False
-2,454,172,138,-34,False
-2,247,154,156,2,False
-2,40,136,138,2,False
-2,339,162,148,-14,False
-2,132,144,146,2,False
-2,431,170,140,-30,False
-2,224,152,154,2,False
-2,17,134,136,2,False
-2,316,160,150,-10,False
-2,109,142,144,2,False
-2,408,168,142,-26,False
-2,201,150,152,2,False
-2,500,176,134,-42,False
-2,293,158,152,-6,False
-2,86,140,142,2,False
-2,385,166,144,-22,False
-2,178,148,150,2,False
-2,477,174,136,-38,False
-2,270,156,154,-2,False
-2,63,138,140,2,False
-2,362,164,146,-18,False
-2,155,146,148,2,False
-2,454,172,138,-34,False
-2,247,154,156,2,False
-2,40,136,138,2,False
-2,339,162,148,-14,False
-2,132,144,146,2,False
-2,431,170,140,-30,False
-2,224,152,154,2,False
-2,17,134,136,2,False
-2,316,160,150,-10,False
-2,109,142,144,2,False
-2,408,168,142,-26,False
-2,201,150,152,2,False
-2,500,176,134,-42,False
-2,293,158,152,-6,False
-2,86,140,142,2,False
-2,385,166,144,-22,False
-2,178,148,150,2,False
-2,477,174,136,-38,False
-2,270,156,154,-2,False
-2,63,138,140,2,False
-2,362,164,146,-18,False
-2,155,146,148,2,False
-2,454,172,138,-34,False
-2,247,154,156,2,False
-2,40,136,138,2,False
-2,339,162,148,-14,False
-2,132,144,146,2,False
-2,431,170,140,-30,False
-2,224,152,154,2,False
-2,17,134,136,2,False
-2,316,160,150,-10,False
-2,109,142,144,2,False
-2,408,168,142,-26,False
-2,201,150,152,2,False
-2,500,176,134,-42,False
-2,293,158,152,-6,False
-2,86,140,142,2,False
-2,385,166,144,-22,False
-2,178,148,150,2,False
-2,477,174,136,-38,False
-2,270,156,154,-2,False
-2,63,138,140,2,False
-2,362,164,146,-18,False
-2,155,146,148,2,False
-2,454,172,138,-34,False
-2,247,154,156,2,False
-2,40,136,138,2,False
-2,339,162,148,-14,False
-2,132,144,146,2,False
-2,431,170,140,-30,False
-2,224,152,154,2,False
-2,17,134,136,2,False
-2,316,160,150,-10,False
-2,109,142,144,2,False
-2,408,168,142,-26,False
-2,201,150,152,2,False
-2,500,176,134,-42,False
-2,293,158,152,-6,False
-2,86,140,142,2,False
-2,385,166,144,-22,False
-2,178,148,150,2,False
-2,477,174,136,-38,False
-2,270,156,154,-2,False
-2,63,138,140,2,False
-2,362,164,146,-18,False
-2,155,146,148,2,False
-2,454,172,138,-34,False
-2,247,154,156,2,False
-2,40,136,138,2,False
-2,339,162,148,-14,False
-2,132,144,146,2,False
-2,431,170,140,-30,False
-2,224,152,154,2,False
-2,17,134,136,2,False
-2,316,160,150,-10,False
-2,109,142,144,2,False
-2,408,168,142,-26,False
-2,201,150,152,2,False
-2,500,176,134,-42,False
-2,293,158,152,-6,False
-2,86,140,142,2,False
-2,385,166,144,-22,False
-2,178,148,150,2,False
-2,477,174,136,-38,False
-2,270,156,154,-2,False
-2,63,138,140,2,False
-2,362,164,146,-18,False
-2,155,146,148,2,False
-2,454,172,138,-34,False
-2,247,154,156,2,False
-2,40,136,138,2,False
-2,339,162,148,-14,False
-2,132,144,146,2,False
-2,431,170,140,-30,False
-2,224,152,154,2,False
-2,17,134,136,2,False
-2,316,160,150,-10,False
-2,109,142,144,2,False
-2,408,168,142,-26,False
-2,201,150,152,2,False
-2,500,176,134,-42,False
-2,293,158,152,-6,False
-2,86,140,142,2,False
-2,385,166,144,-22,False
-2,178,148,150,2,False
-2,477,174,136,-38,False
-2,270,156,154,-2,False
-2,63,138,140,2,False
-2,362,164,146,-18,False
-2,155,146,148,2,False
-2,454,172,138,-34,False
-2,247,154,156,2,False
-2,40,136,138,2,False
-2,339,162,148,-14,False
-2,132,144,146,2,False
-2,431,170,140,-30,False
-2,224,152,154,2,False
-2,17,134,136,2,False
-2,316,160,150,-10,False
-2,109,142,144,2,False
-2,408,168,142,-26,False
-2,201,150,152,2,False
-2,500,176,134,-42,False
-2,293,158,152,-6,False
-2,86,140,142,2,False
-2,385,166,144,-22,False
-2,178,148,150,2,False
-2,477,174,136,-38,False
-2,270,156,154,-2,False
-2,63,138,140,2,False
-2,362,164,146,-18,False
-2,155,146,148,2,False
-2,454,172,138,-34,False
-2,247,154,156,2,False
-2,40,136,138,2,False
-2,339,162,148,-14,False
-2,132,144,146,2,False
-2,431,170,140,-30,False
-2,224,152,154,2,False
-2,17,134,136,2,False
-2,316,160,150,-10,False
-2,109,142,144,2,False
-2,408,168,142,-26,False
-2,201,150,152,2,False
-2,500,176,134,-42,False
-2,293,158,152,-6,False
-2,86,140,142,2,False
-2,385,166,144,-22,False
-2,178,148,150,2,False
-2,477,174,136,-38,False
-2,270,156,154,-2,False
-2,63,138,140,2,False
-2,362,164,146,-18,False
-2,155,146,148,2,False
-2,454,172,138,-34,False
-2,247,154,156,2,False
-2,40,136,138,2,False
-2,339,162,148,-14,False
-2,132,144,146,2,False
-2,431,170,140,-30,False
-2,224,152,154,2,False
-2,17,134,136,2,False
-2,316,160,150,-10,False
-2,109,142,144,2,False
-2,408,168,142,-26,False
-2,201,150,152,2,False
-2,500,176,134,-42,False
-2,293,158,152,-6,False
-2,86,140,142,2,False
-2,385,166,144,-22,False
-2,178,148,150,2,False
-2,477,174,136,-38,False
-2,270,156,154,-2,False
-2,63,138,140,2,False
-2,362,164,146,-18,False
-2,155,146,148,2,False
-2,454,172,138,-34,False
-2,247,154,156,2,False
-2,40,136,138,2,False
-2,339,162,148,-14,False
-2,132,144,146,2,False
-2,431,170,140,-30,False
-2,224,152,154,2,False
-2,17,134,136,2,False
-2,316,160,150,-10,False
-2,109,142,144,2,False
-2,408,168,142,-26,False
-2,201,150,152,2,False
-2,500,176,134,-42,False
-2,293,158,152,-6,False
-2,86,140,142,2,False
-2,385,166,144,-22,False
-2,178,148,150,2,False
-2,477,174,136,-38,False
-2,270,156,154,-2,False
-2,63,138,140,2,False
-2,362,164,146,-18,False
-2,155,146,148,2,False
-2,454,172,138,-34,False
-2,247,154,156,2,False
-2,40,136,138,2,False
-2,339,162,148,-14,False
-2,132,144,146,2,False
-2,431,170,140,-30,False
-2,224,152,154,2,False
-2,17,134,136,2,False
-2,316,160,150,-10,False
-2,109,142,144,2,False
-2,408,168,142,-26,False
-2,201,150,152,2,False
-2,500,176,134,-42,False
-2,293,158,152,-6,False
-2,86,140,142,2,False
-2,385,166,144,-22,False
-2,178,148,150,2,False
-2,477,174,136,-38,False
-2,270,156,154,-2,False
-2,63,138,140,2,False
-2,362,164,146,-18,False
-2,155,146,148,2,False
-2,454,172,138,-34,False
-2,247,154,156,2,False
-2,40,136,138,2,False
-2,339,162,148,-14,False
-2,132,144,146,2,False
-2,431,170,140,-30,False
-2,224,152,154,2,False
-2,17,134,136,2,False
-2,316,160,150,-10,False
-2,109,142,144,2,False
-2,408,168,142,-26,False
-2,201,150,152,2,False
-2,500,176,134,-42,False
-2,293,158,152,-6,False
-2,86,140,142,2,False
-2,385,166,144,-22,False
-2,178,148,150,2,False
-2,477,174,136,-38,False
-2,270,156,154,-2,False
-2,63,138,140,2,False
-2,362,164,146,-18,False
-2,155,146,148,2,False
-2,454,172,138,-34,False
-2,247,154,156,2,False
-2,40,136,138,2,False
-2,339,162,148,-14,False
-2,132,144,146,2,False
-2,431,170,140,-30,False
-2,224,152,154,2,False
-2,17,134,136,2,False
-2,316,160,150,-10,False
-2,109,142,144,2,False
-2,408,168,142,-26,False
-2,201,150,152,2,False
-2,500,176,134,-42,False
-2,293,158,152,-6,False
-2,86,140,142,2,False
-2,385,166,144,-22,False
-2,178,148,150,2,False
-2,477,174,136,-38,False
-2,270,156,154,-2,False
-2,63,138,140,2,False
-2,362,164,146,-18,False
-2,155,146,148,2,False
-2,454,172,138,-34,False
-2,247,154,156,2,False
-2,40,136,138,2,False
-2,339,162,148,-14,False
-2,132,144,146,2,False
-2,431,170,140,-30,False
-2,224,152,154,2,False
-2,17,134,136,2,False
-2,316,160,150,-10,False
-2,109,142,144,2,False
-2,408,168,142,-26,False
-2,201,150,152,2,False
-2,500,176,134,-42,False
-2,293,158,152,-6,False
-2,86,140,142,2,False
-2,385,166,144,-22,False
-2,178,148,150,2,False
-2,477,174,136,-38,False
-2,270,156,154,-2,False
-2,63,138,140,2,False
-2,362,164,146,-18,False
-2,155,146,148,2,False
-2,454,172,138,-34,False
-2,247,154,156,2,False
-2,40,136,138,2,False
-2,339,162,148,-14,False
-2,132,144,146,2,False
-2,431,170,140,-30,False
-2,224,152,154,2,False
-2,17,134,136,2,False
-2,316,160,150,-10,False
-2,109,142,144,2,False
-2,408,168,142,-26,False
-2,201,150,152,2,False
-2,500,176,134,-42,False
-2,293,158,152,-6,False
-2,86,140,142,2,False
-2,385,166,144,-22,False
-2,178,148,150,2,False
-2,477,174,136,-38,False
-2,270,156,154,-2,False
-2,63,138,140,2,False
-2,362,164,146,-18,False
-2,155,146,148,2,False
-2,454,172,138,-34,False
-2,247,154,156,2,False
-2,40,136,138,2,False
-2,339,162,148,-14,False
-2,132,144,146,2,False
-2,431,170,140,-30,False
-2,224,152,154,2,False
-2,17,134,136,2,False
-2,316,160,150,-10,False
-2,109,142,144,2,False
-2,408,168,142,-26,False
-2,201,150,152,2,False
-2,500,176,134,-42,False
-2,293,158,152,-6,False
-2,86,140,142,2,False
-2,385,166,144,-22,False
-2,178,148,150,2,False
-2,477,174,136,-38,False
-2,270,156,154,-2,False
-2,63,138,140,2,False
-2,362,164,146,-18,False
-2,155,146,148,2,False
-2,454,172,138,-34,False
-2,247,154,156,2,False
-2,40,136,138,2,False
-2,339,162,148,-14,False
-2,132,144,146,2,False
-2,431,170,140,-30,False
-2,224,152,154,2,False
-2,17,134,136,2,False
-2,316,160,150,-10,False
-2,109,142,144,2,False
-2,408,168,142,-26,False
-2,201,150,152,2,False
-2,500,176,134,-42,False
-2,293,158,152,-6,False
-2,86,140,142,2,False
-2,385,166,144,-22,False
-2,178,148,150,2,False
-2,477,174,136,-38,False
-2,270,156,154,-2,False
-2,63,138,140,2,False
-2,362,164,146,-18,False
-2,155,146,148,2,False
-2,454,172,138,-34,False
-2,247,154,156,2,False
-2,40,136,138,2,False
-2,339,162,148,-14,False
-2,132,144,146,2,False
-2,431,170,140,-30,False
-2,224,152,154,2,False
-2,17,134,136,2,False
-2,316,160,150,-10,False
-2,109,142,144,2,False
-2,408,168,142,-26,False
-2,201,150,152,2,False
-2,500,176,134,-42,False
-2,293,158,152,-6,False
-2,86,140,142,2,False
-2,385,166,144,-22,False
-2,178,148,150,2,False
-2,477,174,136,-38,False
-2,270,156,154,-2,False
-2,63,138,140,2,False
-2,362,164,146,-18,False
-2,155,146,148,2,False
-2,454,172,138,-34,False
-2,247,154,156,2,False
-2,40,136,138,2,False
-2,339,162,148,-14,False
-2,132,144,146,2,False
-2,431,170,140,-30,False
-2,224,152,154,2,False
-2,17,134,136,2,False
-2,316,160,150,-10,False
-2,109,142,144,2,False
-2,408,168,142,-26,False
-2,201,150,152,2,False
-2,500,176,134,-42,False
-2,293,158,152,-6,False
-2,86,140,142,2,False
-2,385,166,144,-22,False
-2,178,148,150,2,False
-2,477,174,136,-38,False
-2,270,156,154,-2,False
-2,63,138,140,2,False
-2,362,164,146,-18,False
-2,155,146,148,2,False
-2,454,172,138,-34,False
-2,247,154,156,2,False
-2,40,136,138,2,False
-2,339,162,148,-14,False
-2,132,144,146,2,False
-2,431,170,140,-30,False
-2,224,152,154,2,False
-2,17,134,136,2,False
-2,316,160,150,-10,False
-2,109,142,144,2,False
-2,408,168,142,-26,False
-2,201,150,152,2,False
-2,500,176,134,-42,False
-2,293,158,152,-6,False
-2,86,140,142,2,False
-2,385,166,144,-22,False
-2,178,148,150,2,False
-2,477,174,136,-38,False
-2,270,156,154,-2,False
-2,63,138,140,2,False
-2,362,164,146,-18,False
-2,155,146,148,2,False
-2,454,172,138,-34,False
-2,247,154,156,2,False
-2,40,136,138,2,False
-2,339,162,148,-14,False
-2,132,144,146,2,False
-2,431,170,140,-30,False
-2,224,152,154,2,False
-2,17,134,136,2,False
-2,316,160,150,-10,False
-2,109,142,144,2,False
-2,408,168,142,-26,False
-2,201,150,152,2,False
-2,500,176,134,-42,False
-2,293,158,152,-6,False
-2,86,140,142,2,False
-2,385,166,144,-22,False
-2,178,148,150,2,False
-2,477,174,136,-38,False
-2,270,156,154,-2,False
-2,63,138,140,2,False
-2,362,164,146,-18,False
-2,155,146,148,2,False
-2,454,172,138,-34,False
-2,247,154,156,2,False
-2,40,136,138,2,False
-2,339,162,148,-14,False
-2,132,144,146,2,False
-2,431,170,140,-30,False
-2,224,152,154,2,False
-2,17,134,136,2,False
-2,316,160,150,-10,False
-2,109,142,144,2,False
-2,408,168,142,-26,False
-2,201,150,152,2,False
-2,500,176,134,-42,False
-2,293,158,152,-6,False
-2,86,140,142,2,False
-2,385,166,144,-22,False
-2,178,148,150,2,False
-2,477,174,136,-38,False
-2,270,156,154,-2,False
-2,63,138,140,2,False
-2,362,164,146,-18,False
-2,155,146,148,2,False
-2,454,172,138,-34,False
-2,247,154,156,2,False
-2,40,136,138,2,False
-2,339,162,148,-14,False
-2,132,144,146,2,False
-2,431,170,140,-30,False
-2,224,152,154,2,False
-2,17,134,136,2,False
-2,316,160,150,-10,False
-2,109,142,144,2,False
-2,408,168,142,-26,False
-2,201,150,152,2,False
-2,500,176,134,-42,False
-2,293,158,152,-6,False
-2,86,140,142,2,False
-2,385,166,144,-22,False
-2,178,148,150,2,False
-2,477,174,136,-38,False
-2,270,156,154,-2,False
-2,63,138,140,2,False
-2,362,164,146,-18,False
-2,155,146,148,2,False
-2,454,172,138,-34,False
-2,247,154,156,2,False
-2,40,136,138,2,False
-2,339,162,148,-14,False
-2,132,144,146,2,False
-2,431,170,140,-30,False
-2,224,152,154,2,False
-2,17,134,136,2,False
-2,316,160,150,-10,False
-2,109,142,144,2,False
-2,408,168,142,-26,False
-2,201,150,152,2,False
-2,500,176,134,-42,False
-2,293,158,152,-6,False
-2,86,140,142,2,False
-2,385,166,144,-22,False
-2,178,148,150,2,False
-2,477,174,136,-38,False
-2,270,156,154,-2,False
-2,63,138,140,2,False
-2,362,164,146,-18,False
-2,155,146,148,2,False
-2,454,172,138,-34,False
-2,247,154,156,2,False
-2,40,136,138,2,False
-2,339,162,148,-14,False
-2,132,144,146,2,False
-2,431,170,140,-30,False
-2,224,152,154,2,False
-2,17,134,136,2,False
-2,316,160,150,-10,False
-2,109,142,144,2,False
-2,408,168,142,-26,False
-2,201,150,152,2,False
-2,500,176,134,-42,False
-2,293,158,152,-6,False
-2,86,140,142,2,False
-2,385,166,144,-22,False
-2,178,148,150,2,False
-2,477,174,136,-38,False
-2,270,156,154,-2,False
-2,63,138,140,2,False
-2,362,164,146,-18,False
-2,155,146,148,2,False
-2,454,172,138,-34,False
-2,247,154,156,2,False
-2,40,136,138,2,False
-2,339,162,148,-14,False
-2,132,144,146,2,False
-2,431,170,140,-30,False
-2,224,152,154,2,False
-2,17,134,136,2,False
-2,316,160,150,-10,False
-2,109,142,144,2,False
-2,408,168,142,-26,False
-2,201,150,152,2,False
-2,500,176,134,-42,False
-2,293,158,152,-6,False
-2,86,140,142,2,False
-2,385,166,144,-22,False
-2,178,148,150,2,False
-2,477,174,136,-38,False
-2,270,156,154,-2,False
-2,63,138,140,2,False
-2,362,164,146,-18,False
-2,155,146,148,2,False
-2,454,172,138,-34,False
-2,247,154,156,2,False
-2,40,136,138,2,False
-2,339,162,148,-14,False
-2,132,144,146,2,False
-2,431,170,140,-30,False
-2,224,152,154,2,False
-2,17,134,136,2,False
-2,316,160,150,-10,False
-2,109,142,144,2,False
-2,408,168,142,-26,False
-2,201,150,152,2,False
-2,500,176,134,-42,False
-2,293,158,152,-6,False
-2,86,140,142,2,False
-2,385,166,144,-22,False
-2,178,148,150,2,False
-2,477,174,136,-38,False
-2,270,156,154,-2,False
-2,63,138,140,2,False
-2,362,164,146,-18,False
-2,155,146,148,2,False
-2,454,172,138,-34,False
-2,247,154,156,2,False
-2,40,136,138,2,False
-2,339,162,148,-14,False
-2,132,144,146,2,False
-2,431,170,140,-30,False
-2,224,152,154,2,False
-2,17,134,136,2,False
-2,316,160,150,-10,False
-2,109,142,144,2,False
-2,408,168,142,-26,False
-2,201,150,152,2,False
-2,500,176,134,-42,False
-2,293,158,152,-6,False
-2,86,140,142,2,False
-2,385,166,144,-22,False
-2,178,148,150,2,False
-2,477,174,136,-38,False
-2,270,156,154,-2,False
-2,63,138,140,2,False
-2,362,164,146,-18,False
-2,155,146,148,2,False
-2,454,172,138,-34,False
-2,247,154,156,2,False
-2,40,136,138,2,False
-2,339,162,148,-14,False
-2,132,144,146,2,False
-2,431,170,140,-30,False
-2,224,152,154,2,False
-2,17,134,136,2,False
-2,316,160,150,-10,False
-2,109,142,144,2,False
-2,408,168,142,-26,False
-2,201,150,152,2,False
-2,500,176,134,-42,False
-2,293,158,152,-6,False
-2,86,140,142,2,False
-2,385,166,144,-22,False
-2,178,148,150,2,False
-2,477,174,136,-38,False
-2,270,156,154,-2,False
-2,63,138,140,2,False
-2,362,164,146,-18,False
-2,155,146,148,2,False
-2,454,172,138,-34,False
-2,247,154,156,2,False
-2,40,136,138,2,False
-2,339,162,148,-14,False
-2,132,144,146,2,False
-2,431,170,140,-30,False
-2,224,152,154,2,False
-2,17,134,136,2,False
-2,316,160,150,-10,False
-2,109,142,144,2,False
-2,408,168,142,-26,False
-2,201,150,152,2,False
-2,500,176,134,-42,False
-2,293,158,152,-6,False
-2,86,140,142,2,False
-2,385,166,144,-22,False
-2,178,148,150,2,False
-2,477,174,136,-38,False
-2,270,156,154,-2,False
-2,63,138,140,2,False
-2,362,164,146,-18,False
-2,155,146,148,2,False
-2,454,172,138,-34,False
-2,247,154,156,2,False
-2,40,136,138,2,False
-2,339,162,148,-14,False
-2,132,144,146,2,False
-2,431,170,140,-30,False
-2,224,152,154,2,False
-2,17,134,136,2,False
-2,316,160,150,-10,False
-2,109,142,144,2,False
-2,408,168,142,-26,False
-2,201,150,152,2,False
-2,500,176,134,-42,False
-2,293,158,152,-6,False
-2,86,140,142,2,False
-2,385,166,144,-22,False
-2,178,148,150,2,False
-2,477,174,136,-38,False
-2,270,156,154,-2,False
-2,63,138,140,2,False
-2,362,164,146,-18,False
-2,155,146,148,2,False
-2,454,172,138,-34,False
-2,247,154,156,2,False
-2,40,136,138,2,False
-2,339,162,148,-14,False
-2,132,144,146,2,False
-2,431,170,140,-30,False
-2,224,152,154,2,False
-2,17,134,136,2,False
-2,316,160,150,-10,False
-2,109,142,144,2,False
-2,408,168,142,-26,False
-2,201,150,152,2,False
-2,500,176,134,-42,False
-2,293,158,152,-6,False
-2,86,140,142,2,False
-2,385,166,144,-22,False
-2,178,148,150,2,False
-2,477,174,136,-38,False
-2,270,156,154,-2,False
-2,63,138,140,2,False
-2,362,164,146,-18,False
-2,155,146,148,2,False
-2,454,172,138,-34,False
-2,247,154,156,2,False
-2,40,136,138,2,False
-2,339,162,148,-14,False
-2,132,144,146,2,False
-2,431,170,140,-30,False
-2,224,152,154,2,False
-2,17,134,136,2,False
-2,316,160,150,-10,False
-2,109,142,144,2,False
-2,408,168,142,-26,False
-2,201,150,152,2,False
-2,500,176,134,-42,False
-2,293,158,152,-6,False
-2,86,140,142,2,False
-2,385,166,144,-22,False
-2,178,148,150,2,False
-2,477,174,136,-38,False
-2,270,156,154,-2,False
-2,63,138,140,2,False
-2,362,164,146,-18,False
-2,155,146,148,2,False
-2,454,172,138,-34,False
-2,247,154,156,2,False
-2,40,136,138,2,False
-2,339,162,148,-14,False
-2,132,144,146,2,False
-2,431,170,140,-30,False
-2,224,152,154,2,False
-2,17,134,136,2,False
-2,316,160,150,-10,False
-2,109,142,144,2,False
-2,408,168,142,-26,False
-2,201,150,152,2,False
-2,500,176,134,-42,False
-2,293,158,152,-6,False
-2,86,140,142,2,False
-2,385,166,144,-22,False
-2,178,148,150,2,False
-2,477,174,136,-38,False
-2,270,156,154,-2,False
-2,63,138,140,2,False
-2,362,164,146,-18,False
-2,155,146,148,2,False
-2,454,172,138,-34,False
-2,247,154,156,2,False
-2,40,136,138,2,False
-2,339,162,148,-14,False
-2,132,144,146,2,False
-2,431,170,140,-30,False
-2,224,152,154,2,False
-2,17,134,136,2,False
-2,316,160,150,-10,False
-2,109,142,144,2,False
-2,408,168,142,-26,False
-2,201,150,152,2,False
-2,500,176,134,-42,False
-2,293,158,152,-6,False
-2,86,140,142,2,False
-2,385,166,144,-22,False
-2,178,148,150,2,False
-2,477,174,136,-38,False
-2,270,156,154,-2,False
-2,63,138,140,2,False
-2,362,164,146,-18,False
-2,155,146,148,2,False
-2,454,172,138,-34,False
-2,247,154,156,2,False
-2,40,136,138,2,False
-2,339,162,148,-14,False
-2,132,144,146,2,False
-2,431,170,140,-30,False
-2,224,152,154,2,False
-2,17,134,136,2,False
-2,316,160,150,-10,False
-2,109,142,144,2,False
-2,408,168,142,-26,False
-2,201,150,152,2,False
-2,500,176,134,-42,False
-2,293,158,152,-6,False
-2,86,140,142,2,False
-2,385,166,144,-22,False
-2,178,148,150,2,False
-2,477,174,136,-38,False
-2,270,156,154,-2,False
-2,63,138,140,2,False
-2,362,164,146,-18,False
-2,155,146,148,2,False
-2,454,172,138,-34,False
-2,247,154,156,2,False
-2,40,136,138,2,False
-2,339,162,148,-14,False
-2,132,144,146,2,False
-2,431,170,140,-30,False
-2,224,152,154,2,False
-2,17,134,136,2,False
-2,316,160,150,-10,False
-2,109,142,144,2,False
-2,408,168,142,-26,False
-2,201,150,152,2,False
-2,500,176,134,-42,False
-2,293,158,152,-6,False
-2,86,140,142,2,False
-2,385,166,144,-22,False
-2,178,148,150,2,False
-2,477,174,136,-38,False
-2,270,156,154,-2,False
-2,63,138,140,2,False
-2,362,164,146,-18,False
-2,155,146,148,2,False
-2,454,172,138,-34,False
-2,247,154,156,2,False
-2,40,136,138,2,False
-2,339,162,148,-14,False
-2,132,144,146,2,False
-2,431,170,140,-30,False
-2,224,152,154,2,False
-2,17,134,136,2,False
-2,316,160,150,-10,False
-2,109,142,144,2,False
-2,408,168,142,-26,False
-2,201,150,152,2,False
-2,500,176,134,-42,False
-2,293,158,152,-6,False
-2,86,140,142,2,False
-2,385,166,144,-22,False
-2,178,148,150,2,False
-2,477,174,136,-38,False
-2,270,156,154,-2,False
-2,63,138,140,2,False
-2,362,164,146,-18,False
-2,155,146,148,2,False
-2,454,172,138,-34,False
-2,247,154,156,2,False
-2,40,136,138,2,False
-2,339,162,148,-14,False
-2,132,144,146,2,False
-2,431,170,140,-30,False
-2,224,152,154,2,False
-2,17,134,136,2,False
-2,316,160,150,-10,False
-2,109,142,144,2,False
-2,408,168,142,-26,False
-2,201,150,152,2,False
-2,500,176,134,-42,False
-2,293,158,152,-6,False
-2,86,140,142,2,False
-2,385,166,144,-22,False
-2,178,148,150,2,False
-2,477,174,136,-38,False
-2,270,156,154,-2,False
-2,63,138,140,2,False
-2,362,164,146,-18,False
-2,155,146,148,2,False
-2,454,172,138,-34,False
-2,247,154,156,2,False
-2,40,136,138,2,False
-2,339,162,148,-14,False
-2,132,144,146,2,False
-2,431,170,140,-30,False
-2,224,152,154,2,False
-2,17,134,136,2,False
-2,316,160,150,-10,False
-2,109,142,144,2,False
-2,408,168,142,-26,False
-2,201,150,152,2,False
-2,500,176,134,-42,False
-2,293,158,152,-6,False
-2,86,140,142,2,False
-2,385,166,144,-22,False
-2,178,148,150,2,False
-2,477,174,136,-38,False
-2,270,156,154,-2,False
-2,63,138,140,2,False
-2,362,164,146,-18,False
-2,155,146,148,2,False
-2,454,172,138,-34,False
-2,247,154,156,2,False
-2,40,136,138,2,False
-2,339,162,148,-14,False
-2,132,144,146,2,False
-2,431,170,140,-30,False
-2,224,152,154,2,False
-2,17,134,136,2,False
-2,316,160,150,-10,False
-2,109,142,144,2,False
-2,408,168,142,-26,False
-2,201,150,152,2,False
-2,500,176,134,-42,False
-2,293,158,152,-6,False
-2,86,140,142,2,False
-2,385,166,144,-22,False
-2,178,148,150,2,False
-2,477,174,136,-38,False
-2,270,156,154,-2,False
-2,63,138,140,2,False
-2,362,164,146,-18,False
-2,155,146,148,2,False
-2,454,172,138,-34,False
-2,247,154,156,2,False
-2,40,136,138,2,False
-2,339,162,148,-14,False
-2,132,144,146,2,False
-2,431,170,140,-30,False
-2,224,152,154,2,False
-2,17,134,136,2,False
-2,316,160,150,-10,False
-2,109,142,144,2,False
-2,408,168,142,-26,False
-2,201,150,152,2,False
-2,500,176,134,-42,False
-2,293,158,152,-6,False
-2,86,140,142,2,False
-2,385,166,144,-22,False
-2,178,148,150,2,False
-2,477,174,136,-38,False
-2,270,156,154,-2,False
-2,63,138,140,2,False
-2,362,164,146,-18,False
-2,155,146,148,2,False
-2,454,172,138,-34,False
-2,247,154,156,2,False
-2,40,136,138,2,False
-2,339,162,148,-14,False
-2,132,144,146,2,False
-2,431,170,140,-30,False
-2,224,152,154,2,False
-2,17,134,136,2,False
-2,316,160,150,-10,False
-2,109,142,144,2,False
-2,408,168,142,-26,False
-2,201,150,152,2,False
-2,500,176,134,-42,False
-2,293,158,152,-6,False
-2,86,140,142,2,False
-2,385,166,144,-22,False
-2,178,148,150,2,False
-2,477,174,136,-38,False
-2,270,156,154,-2,False
-2,63,138,140,2,False
-2,362,164,146,-18,False
-2,155,146,148,2,False
-2,454,172,138,-34,False
-2,247,154,156,2,False
-2,40,136,138,2,False
-2,339,162,148,-14,False
-2,132,144,146,2,False
-2,431,170,140,-30,False
-2,224,152,154,2,False
-2,17,134,136,2,False
-2,316,160,150,-10,False
-2,109,142,144,2,False
-2,408,168,142,-26,False
-2,201,150,152,2,False
-2,500,176,134,-42,False
-2,293,158,152,-6,False
-2,86,140,142,2,False
-2,385,166,144,-22,False
-2,178,148,150,2,False
-2,477,174,136,-38,False
-2,270,156,154,-2,False
-2,63,138,140,2,False
-2,362,164,146,-18,False
-2,155,146,148,2,False
-2,454,172,138,-34,False
-2,247,154,156,2,False
-2,40,136,138,2,False
-2,339,162,148,-14,False
-2,132,144,146,2,False
-2,431,170,140,-30,False
-2,224,152,154,2,False
-2,17,134,136,2,False
-2,316,160,150,-10,False
-2,109,142,144,2,False
-2,408,168,142,-26,False
-2,201,150,152,2,False
-2,500,176,134,-42,False
-2,293,158,152,-6,False
-2,86,140,142,2,False
-2,385,166,144,-22,False
-2,178,148,150,2,False
-2,477,174,136,-38,False
-2,270,156,154,-2,False
-2,63,138,140,2,False
-2,362,164,146,-18,False
-2,155,146,148,2,False
-2,454,172,138,-34,False
-2,247,154,156,2,False
-2,40,136,138,2,False
-2,339,162,148,-14,False
-2,132,144,146,2,False
-2,431,170,140,-30,False
-2,224,152,154,2,False
-2,17,134,136,2,False
-2,316,160,150,-10,False
-2,109,142,144,2,False
-2,408,168,142,-26,False
-2,201,150,152,2,False
-2,500,176,134,-42,False
-2,293,158,152,-6,False
-2,86,140,142,2,False
-2,385,166,144,-22,False
-2,178,148,150,2,False
-2,477,174,136,-38,False
-2,270,156,154,-2,False
-2,63,138,140,2,False
-2,362,164,146,-18,False
-2,155,146,148,2,False
-2,454,172,138,-34,False
-2,247,154,156,2,False
-2,40,136,138,2,False
-2,339,162,148,-14,False
-2,132,144,146,2,False
-2,431,170,140,-30,False
-2,224,152,154,2,False
-2,17,134,136,2,False
-2,316,160,150,-10,False
-2,109,142,144,2,False
-2,408,168,142,-26,False
-2,201,150,152,2,False
-2,500,176,134,-42,False
-2,293,158,152,-6,False
-2,86,140,142,2,False
-2,385,166,144,-22,False
-2,178,148,150,2,False
-2,477,174,136,-38,False
-2,270,156,154,-2,False
-2,63,138,140,2,False
-2,362,164,146,-18,False
-2,155,146,148,2,False
-2,454,172,138,-34,False
-2,247,154,156,2,False
-2,40,136,138,2,False
-2,339,162,148,-14,False
-2,132,144,146,2,False
-2,431,170,140,-30,False
-2,224,152,154,2,False
-2,17,134,136,2,False
-2,316,160,150,-10,False
-2,109,142,144,2,False
-2,408,168,142,-26,False
-2,201,150,152,2,False
-2,500,176,134,-42,False
-2,293,158,152,-6,False
-2,86,140,142,2,False
-2,385,166,144,-22,False
-2,178,148,150,2,False
-2,477,174,136,-38,False
-2,270,156,154,-2,False
-2,63,138,140,2,False
-2,362,164,146,-18,False
-2,155,146,148,2,False
-2,454,172,138,-34,False
-2,247,154,156,2,False
-2,40,136,138,2,False
-2,339,162,148,-14,False
-2,132,144,146,2,False
-2,431,170,140,-30,False
-2,224,152,154,2,False
-2,17,134,136,2,False
-2,316,160,150,-10,False
-2,109,142,144,2,False
-2,408,168,142,-26,False
-2,201,150,152,2,False
-2,500,176,134,-42,False
-2,293,158,152,-6,False
-2,86,140,142,2,False
-2,385,166,144,-22,False
-2,178,148,150,2,False
-2,477,174,136,-38,False
-2,270,156,154,-2,False
-2,63,138,140,2,False
-2,362,164,146,-18,False
-2,155,146,148,2,False
-2,454,172,138,-34,False
-2,247,154,156,2,False
-2,40,136,138,2,False
-2,339,162,148,-14,False
-2,132,144,146,2,False
-2,431,170,140,-30,False
-2,224,152,154,2,False
-2,17,134,136,2,False
-2,316,160,150,-10,False
-2,109,142,144,2,False
-2,408,168,142,-26,False
-2,201,150,152,2,False
-2,500,176,134,-42,False
-2,293,158,152,-6,False
-2,86,140,142,2,False
-2,385,166,144,-22,False
-2,178,148,150,2,False
-2,477,174,136,-38,False
-2,270,156,154,-2,False
-2,63,138,140,2,False
-2,362,164,146,-18,False
-2,155,146,148,2,False
-2,454,172,138,-34,False
-2,247,154,156,2,False
-2,40,136,138,2,False
-2,339,162,148,-14,False
-2,132,144,146,2,False
-2,431,170,140,-30,False
-2,224,152,154,2,False
-2,17,134,136,2,False
-2,316,160,150,-10,False
-2,109,142,144,2,False
-2,408,168,142,-26,False
-2,201,150,152,2,False
-2,500,176,134,-42,False
-2,293,158,152,-6,False
-2,86,140,142,2,False
-2,385,166,144,-22,False
-2,178,148,150,2,False
-2,477,174,136,-38,False
-2,270,156,154,-2,False
-2,63,138,140,2,False
-2,362,164,146,-18,False
-2,155,146,148,2,False
-2,454,172,138,-34,False
-2,247,154,156,2,False
-2,40,136,138,2,False
-2,339,162,148,-14,False
-2,132,144,146,2,False
-2,431,170,140,-30,False
-2,224,152,154,2,False
-2,17,134,136,2,False
-2,316,160,150,-10,False
-2,109,142,144,2,False
-2,408,168,142,-26,False
-2,201,150,152,2,False
-2,500,176,134,-42,False
-2,293,158,152,-6,False
-2,86,140,142,2,False
-2,385,166,144,-22,False
-2,178,148,150,2,False
-2,477,174,136,-38,False
-2,270,156,154,-2,False
-2,63,138,140,2,False
-2,362,164,146,-18,False
-2,155,146,148,2,False
-2,454,172,138,-34,False
-2,247,154,156,2,False
-2,40,136,138,2,False
-2,339,162,148,-14,False
-2,132,144,146,2,False
-2,431,170,140,-30,False
-2,224,152,154,2,False
-2,17,134,136,2,False
-2,316,160,150,-10,False
-2,109,142,144,2,False
-2,408,168,142,-26,False
-2,201,150,152,2,False
-2,500,176,134,-42,False
-2,293,158,152,-6,False
-2,86,140,142,2,False
-2,385,166,144,-22,False
-2,178,148,150,2,False
-2,477,174,136,-38,False
-2,270,156,154,-2,False
-2,63,138,140,2,False
-2,362,164,146,-18,False
-2,155,146,148,2,False
-2,454,172,138,-34,False
-2,247,154,156,2,False
-2,40,136,138,2,False
-2,339,162,148,-14,False
-2,132,144,146,2,False
-2,431,170,140,-30,False
-2,224,152,154,2,False
-2,17,134,136,2,False
-2,316,160,150,-10,False
-2,109,142,144,2,False
-2,408,168,142,-26,False
-2,201,150,152,2,False
-2,500,176,134,-42,False
-2,293,158,152,-6,False
-2,86,140,142,2,False
-2,385,166,144,-22,False
-2,178,148,150,2,False
-2,477,174,136,-38,False
-2,270,156,154,-2,False
-2,63,138,140,2,False
-2,362,164,146,-18,False
-2,155,146,148,2,False
-2,454,172,138,-34,False
-2,247,154,156,2,False
-2,40,136,138,2,False
-2,339,162,148,-14,False
-2,132,144,146,2,False
-2,431,170,140,-30,False
-2,224,152,154,2,False
-2,17,134,136,2,False
-2,316,160,150,-10,False
-2,109,142,144,2,False
-2,408,168,142,-26,False
-2,201,150,152,2,False
-2,500,176,134,-42,False
-2,293,158,152,-6,False
-2,86,140,142,2,False
-2,385,166,144,-22,False
-2,178,148,150,2,False
-2,477,174,136,-38,False
-2,270,156,154,-2,False
-2,63,138,140,2,False
-2,362,164,146,-18,False
-2,155,146,148,2,False
-2,454,172,138,-34,False
-2,247,154,156,2,False
-2,40,136,138,2,False
-2,339,162,148,-14,False
-2,132,144,146,2,False
-2,431,170,140,-30,False
-2,224,152,154,2,False
-2,17,134,136,2,False
-2,316,160,150,-10,False
-2,109,142,144,2,False
-2,408,168,142,-26,False
-2,201,150,152,2,False
-2,500,176,134,-42,False
-2,293,158,152,-6,False
-2,86,140,142,2,False
-2,385,166,144,-22,False
-2,178,148,150,2,False
-2,477,174,136,-38,False
-2,270,156,154,-2,False
-2,63,138,140,2,False
-2,362,164,146,-18,False
-2,155,146,148,2,False
-2,454,172,138,-34,False
-2,247,154,156,2,False
-2,40,136,138,2,False
-2,339,162,148,-14,False
-2,132,144,146,2,False
-2,431,170,140,-30,False
-2,224,152,154,2,False
-2,17,134,136,2,False
-2,316,160,150,-10,False
-2,109,142,144,2,False
-2,408,168,142,-26,False
-2,201,150,152,2,False
-2,500,176,134,-42,False
-2,293,158,152,-6,False
-2,86,140,142,2,False
-2,385,166,144,-22,False
-2,178,148,150,2,False
-2,477,174,136,-38,False
-2,270,156,154,-2,False
-2,63,138,140,2,False
-2,362,164,146,-18,False
-2,155,146,148,2,False
-2,454,172,138,-34,False
-2,247,154,156,2,False
-2,40,136,138,2,False
-2,339,162,148,-14,False
-2,132,144,146,2,False
-2,431,170,140,-30,False
-2,224,152,154,2,False
-2,17,134,136,2,False
-2,316,160,150,-10,False
-2,109,142,144,2,False
-2,408,168,142,-26,False
-2,201,150,152,2,False
-2,500,176,134,-42,False
-2,293,158,152,-6,False
-2,86,140,142,2,False
-2,385,166,144,-22,False
-2,178,148,150,2,False
-2,477,174,136,-38,False
-2,270,156,154,-2,False
-2,63,138,140,2,False
-2,362,164,146,-18,False
-2,155,146,148,2,False
-2,454,172,138,-34,False
-2,247,154,156,2,False
-2,40,136,138,2,False
-2,339,162,148,-14,False
-2,132,144,146,2,False
-2,431,170,140,-30,False
-2,224,152,154,2,False
-2,17,134,136,2,False
-2,316,160,150,-10,False
-2,109,142,144,2,False
-2,408,168,142,-26,False
-2,201,150,152,2,False
-2,500,176,134,-42,False
-2,293,158,152,-6,False
-2,86,140,142,2,False
-2,385,166,144,-22,False
-2,178,148,150,2,False
-2,477,174,136,-38,False
-2,270,156,154,-2,False
-2,63,138,140,2,False
-2,362,164,146,-18,False
-2,155,146,148,2,False
-2,454,172,138,-34,False
-2,247,154,156,2,False
-2,40,136,138,2,False
-2,339,162,148,-14,False
-2,132,144,146,2,False
-2,431,170,140,-30,False
-2,224,152,154,2,False
-2,17,134,136,2,False
-2,316,160,150,-10,False
-2,109,142,144,2,False
-2,408,168,142,-26,False
-2,201,150,152,2,False
-2,500,176,134,-42,False
-2,293,158,152,-6,False
-2,86,140,142,2,False
-2,385,166,144,-22,False
-2,178,148,150,2,False
-2,477,174,136,-38,False
-2,270,156,154,-2,False
-2,63,138,140,2,False
-2,362,164,146,-18,False
-2,155,146,148,2,False
-2,454,172,138,-34,False
-2,247,154,156,2,False
-2,40,136,138,2,False
-2,339,162,148,-14,False
-2,132,144,146,2,False
-2,431,170,140,-30,False
-2,224,152,154,2,False
-2,17,134,136,2,False
-2,316,160,150,-10,False
-2,109,142,144,2,False
-2,408,168,142,-26,False
-2,201,150,152,2,False
-2,500,176,134,-42,False
-2,293,158,152,-6,False
-2,86,140,142,2,False
-2,385,166,144,-22,False
-2,178,148,150,2,False
-2,477,174,136,-38,False
-2,270,156,154,-2,False
-2,63,138,140,2,False
-2,362,164,146,-18,False
-2,155,146,148,2,False
-2,454,172,138,-34,False
-2,247,154,156,2,False
-2,40,136,138,2,False
-2,339,162,148,-14,False
-2,132,144,146,2,False
-2,431,170,140,-30,False
-2,224,152,154,2,False
-2,17,134,136,2,False
-2,316,160,150,-10,False
-2,109,142,144,2,False
-2,408,168,142,-26,False
-2,201,150,152,2,False
-2,500,176,134,-42,False
-2,293,158,152,-6,False
-2,86,140,142,2,False
-2,385,166,144,-22,False
-2,178,148,150,2,False
-2,477,174,136,-38,False
-2,270,156,154,-2,False
-2,63,138,140,2,False
-2,362,164,146,-18,False
-2,155,146,148,2,False
-2,454,172,138,-34,False
-2,247,154,156,2,False
-2,40,136,138,2,False
-2,339,162,148,-14,False
-2,132,144,146,2,False
-2,431,170,140,-30,False
-2,224,152,154,2,False
-2,17,134,136,2,False
-2,316,160,150,-10,False
-2,109,142,144,2,False
-2,408,168,142,-26,False
-2,201,150,152,2,False
-2,500,176,134,-42,False
-2,293,158,152,-6,False
-2,86,140,142,2,False
-2,385,166,144,-22,False
-2,178,148,150,2,False
-2,477,174,136,-38,False
-2,270,156,154,-2,False
-2,63,138,140,2,False
-2,362,164,146,-18,False
-2,155,146,148,2,False
-2,454,172,138,-34,False
-2,247,154,156,2,False
-2,40,136,138,2,False
-2,339,162,148,-14,False
-2,132,144,146,2,False
-2,431,170,140,-30,False
-2,224,152,154,2,False
-2,17,134,136,2,False
-2,316,160,150,-10,False
-2,109,142,144,2,False
-2,408,168,142,-26,False
-2,201,150,152,2,False
-2,500,176,134,-42,False
-2,293,158,152,-6,False
-2,86,140,142,2,False
-2,385,166,144,-22,False
-2,178,148,150,2,False
-2,477,174,136,-38,False
-2,270,156,154,-2,False
-2,63,138,140,2,False
-2,362,164,146,-18,False
-2,155,146,148,2,False
-2,454,172,138,-34,False
-2,247,154,156,2,False
-2,40,136,138,2,False
-2,339,162,148,-14,False
-2,132,144,146,2,False
-2,431,170,140,-30,False
-2,224,152,154,2,False
-2,17,134,136,2,False
-2,316,160,150,-10,False
-2,109,142,144,2,False
-2,408,168,142,-26,False
-2,201,150,152,2,False
-2,500,176,134,-42,False
-2,293,158,152,-6,False
-2,86,140,142,2,False
-2,385,166,144,-22,False
-2,178,148,150,2,False
-2,477,174,136,-38,False
-2,270,156,154,-2,False
-2,63,138,140,2,False
-2,362,164,146,-18,False
-2,155,146,148,2,False
-2,454,172,138,-34,False
-2,247,154,156,2,False
-2,40,136,138,2,False
-2,339,162,148,-14,False
-2,132,144,146,2,False
-2,431,170,140,-30,False
-2,224,152,154,2,False
-2,17,134,136,2,False
-2,316,160,150,-10,False
-2,109,142,144,2,False
-2,408,168,142,-26,False
-2,201,150,152,2,False
-2,500,176,134,-42,False
-2,293,158,152,-6,False
-2,86,140,142,2,False
-2,385,166,144,-22,False
-2,178,148,150,2,False
-2,477,174,136,-38,False
-2,270,156,154,-2,False
-2,63,138,140,2,False
-2,362,164,146,-18,False
-2,155,146,148,2,False
-2,454,172,138,-34,False
-2,247,154,156,2,False
-2,40,136,138,2,False
-2,339,162,148,-14,False
-2,132,144,146,2,False
-2,431,170,140,-30,False
-2,224,152,154,2,False
-2,17,134,136,2,False
-2,316,160,150,-10,False
-2,109,142,144,2,False
-2,408,168,142,-26,False
-2,201,150,152,2,False
-2,500,176,134,-42,False
-2,293,158,152,-6,False
-2,86,140,142,2,False
-2,385,166,144,-22,False
-2,178,148,150,2,False
-2,477,174,136,-38,False
-2,270,156,154,-2,False
-2,63,138,140,2,False
-2,362,164,146,-18,False
-2,155,146,148,2,False
-2,454,172,138,-34,False
-2,247,154,156,2,False
-2,40,136,138,2,False
-2,339,162,148,-14,False
-2,132,144,146,2,False
-2,431,170,140,-30,False
-2,224,152,154,2,False
-2,17,134,136,2,False
-2,316,160,150,-10,False
-2,109,142,144,2,False
-2,408,168,142,-26,False
-2,201,150,152,2,False
-2,500,176,134,-42,False
-2,293,158,152,-6,False
-2,86,140,142,2,False
-2,385,166,144,-22,False
-2,178,148,150,2,False
-2,477,174,136,-38,False
-2,270,156,154,-2,False
-2,63,138,140,2,False
-2,362,164,146,-18,False
-2,155,146,148,2,False
-2,454,172,138,-34,False
-2,247,154,156,2,False
-2,40,136,138,2,False
-2,339,162,148,-14,False
-2,132,144,146,2,False
-2,431,170,140,-30,False
-2,224,152,154,2,False
-2,17,134,136,2,False
-2,316,160,150,-10,False
-2,109,142,144,2,False
-2,408,168,142,-26,False
-2,201,150,152,2,False
-2,500,176,134,-42,False
-2,293,158,152,-6,False
-2,86,140,142,2,False
-2,385,166,144,-22,False
-2,178,148,150,2,False
-2,477,174,136,-38,False
-2,270,156,154,-2,False
-2,63,138,140,2,False
-2,362,164,146,-18,False
-2,155,146,148,2,False
-2,454,172,138,-34,False
-2,247,154,156,2,False
-2,40,136,138,2,False
-2,339,162,148,-14,False
-2,132,144,146,2,False
-2,431,170,140,-30,False
-2,224,152,154,2,False
-2,17,134,136,2,False
-2,316,160,150,-10,False
-2,109,142,144,2,False
-2,408,168,142,-26,False
-2,201,150,152,2,False
-2,500,176,134,-42,False
-2,293,158,152,-6,False
-2,86,140,142,2,False
-2,385,166,144,-22,False
-2,178,148,150,2,False
-2,477,174,136,-38,False
-2,270,156,154,-2,False
-2,63,138,140,2,False
-2,362,164,146,-18,False
-2,155,146,148,2,False
-2,454,172,138,-34,False
-2,247,154,156,2,False
-2,40,136,138,2,False
-2,339,162,148,-14,False
-2,132,144,146,2,False
-2,431,170,140,-30,False
-2,224,152,154,2,False
-2,17,134,136,2,False
-2,316,160,150,-10,False
-2,109,142,144,2,False
-2,408,168,142,-26,False
-2,201,150,152,2,False
-2,500,176,134,-42,False
-2,293,158,152,-6,False
-2,86,140,142,2,False
-2,385,166,144,-22,False
-2,178,148,150,2,False
-2,477,174,136,-38,False
-2,270,156,154,-2,False
-2,63,138,140,2,False
-2,362,164,146,-18,False
-2,155,146,148,2,False
-2,454,172,138,-34,False
-2,247,154,156,2,False
-2,40,136,138,2,False
-2,339,162,148,-14,False
-2,132,144,146,2,False
-2,431,170,140,-30,False
-2,224,152,154,2,False
-2,17,134,136,2,False
-2,316,160,150,-10,False
-2,109,142,144,2,False
-2,408,168,142,-26,False
-2,201,150,152,2,False
-2,500,176,134,-42,False
-2,293,158,152,-6,False
-2,86,140,142,2,False
-2,385,166,144,-22,False
-2,178,148,150,2,False
-2,477,174,136,-38,False
-2,270,156,154,-2,False
-2,63,138,140,2,False
-2,362,164,146,-18,False
-2,155,146,148,2,False
-2,454,172,138,-34,False
-2,247,154,156,2,False
-2,40,136,138,2,False
-2,339,162,148,-14,False
-2,132,144,146,2,False
-2,431,170,140,-30,False
-2,224,152,154,2,False
-2,17,134,136,2,False
-2,316,160,150,-10,False
-2,109,142,144,2,False
-2,408,168,142,-26,False
-2,201,150,152,2,False
-2,500,176,134,-42,False
-2,293,158,152,-6,False
-2,86,140,142,2,False
-2,385,166,144,-22,False
-2,178,148,150,2,False
-2,477,174,136,-38,False
-2,270,156,154,-2,False
-2,63,138,140,2,False
-2,362,164,146,-18,False
-2,155,146,148,2,False
-2,454,172,138,-34,False
-2,247,154,156,2,False
-2,40,136,138,2,False
-2,339,162,148,-14,False
-2,132,144,146,2,False
-2,431,170,140,-30,False
-2,224,152,154,2,False
-2,17,134,136,2,False
-2,316,160,150,-10,False
-2,109,142,144,2,False
-2,408,168,142,-26,False
-2,201,150,152,2,False
-2,500,176,134,-42,False
-2,293,158,152,-6,False
-2,86,140,142,2,False
-2,385,166,144,-22,False
-2,178,148,150,2,False
-2,477,174,136,-38,False
-2,270,156,154,-2,False
-2,63,138,140,2,False
-2,362,164,146,-18,False
-2,155,146,148,2,False
-2,454,172,138,-34,False
-2,247,154,156,2,False
-2,40,136,138,2,False
-2,339,162,148,-14,False
-2,132,144,146,2,False
-2,431,170,140,-30,False
-2,224,152,154,2,False
-2,17,134,136,2,False
-2,316,160,150,-10,False
-2,109,142,144,2,False
-2,408,168,142,-26,False
-2,201,150,152,2,False
-2,500,176,134,-42,False
-2,293,158,152,-6,False
-2,86,140,142,2,False
-2,385,166,144,-22,False
-2,178,148,150,2,False
-2,477,174,136,-38,False
-2,270,156,154,-2,False
-2,63,138,140,2,False
-2,362,164,146,-18,False
-2,155,146,148,2,False
-2,454,172,138,-34,False
-2,247,154,156,2,False
-2,40,136,138,2,False
-2,339,162,148,-14,False
-2,132,144,146,2,False
-2,431,170,140,-30,False
-2,224,152,154,2,False
-2,17,134,136,2,False
-2,316,160,150,-10,False
-2,109,142,144,2,False
-2,408,168,142,-26,False
-2,201,150,152,2,False
-2,500,176,134,-42,False
-2,293,158,152,-6,False
-2,86,140,142,2,False
-2,385,166,144,-22,False
-2,178,148,150,2,False
-2,477,174,136,-38,False
-2,270,156,154,-2,False
-2,63,138,140,2,False
-2,362,164,146,-18,False
-2,155,146,148,2,False
-2,454,172,138,-34,False
-2,247,154,156,2,False
-2,40,136,138,2,False
-2,339,162,148,-14,False
-2,132,144,146,2,False
-2,431,170,140,-30,False
-2,224,152,154,2,False
-2,17,134,136,2,False
-2,316,160,150,-10,False
-2,109,142,144,2,False
-2,408,168,142,-26,False
-2,201,150,152,2,False
-2,500,176,134,-42,False
-2,293,158,152,-6,False
-2,86,140,142,2,False
-2,385,166,144,-22,False
-2,178,148,150,2,False
-2,477,174,136,-38,False
-2,270,156,154,-2,False
-2,63,138,140,2,False
-2,362,164,146,-18,False
-2,155,146,148,2,False
-2,454,172,138,-34,False
-2,247,154,156,2,False
-2,40,136,138,2,False
-2,339,162,148,-14,False
-2,132,144,146,2,False
-2,431,170,140,-30,False
-2,224,152,154,2,False
-2,17,134,136,2,False
-2,316,160,150,-10,False
-2,109,142,144,2,False
-2,408,168,142,-26,False
-2,201,150,152,2,False
-2,500,176,134,-42,False
-2,293,158,152,-6,False
-2,86,140,142,2,False
-2,385,166,144,-22,False
-2,178,148,150,2,False
-2,477,174,136,-38,False
-2,270,156,154,-2,False
-2,63,138,140,2,False
-2,362,164,146,-18,False
-2,155,146,148,2,False
-2,454,172,138,-34,False
-2,247,154,156,2,False
-2,40,136,138,2,False
-2,339,162,148,-14,False
-2,132,144,146,2,False
-2,431,170,140,-30,False
-2,224,152,154,2,False
-2,17,134,136,2,False
-2,316,160,150,-10,False
-2,109,142,144,2,False
-2,408,168,142,-26,False
-2,201,150,152,2,False
-2,500,176,134,-42,False
-2,293,158,152,-6,False
-2,86,140,142,2,False
-2,385,166,144,-22,False
-2,178,148,150,2,False
-2,477,174,136,-38,False
-2,270,156,154,-2,False
-2,63,138,140,2,False
-2,362,164,146,-18,False
-2,155,146,148,2,False
-2,454,172,138,-34,False
-2,247,154,156,2,False
-2,40,136,138,2,False
-2,339,162,148,-14,False
-2,132,144,146,2,False
-2,431,170,140,-30,False
-2,224,152,154,2,False
-2,17,134,136,2,False
-2,316,160,150,-10,False
-2,109,142,144,2,False
-2,408,168,142,-26,False
-2,201,150,152,2,False
-2,500,176,134,-42,False
-2,293,158,152,-6,False
-2,86,140,142,2,False
-2,385,166,144,-22,False
-2,178,148,150,2,False
-2,477,174,136,-38,False
-2,270,156,154,-2,False
-2,63,138,140,2,False
-2,362,164,146,-18,False
-2,155,146,148,2,False
-2,454,172,138,-34,False
-2,247,154,156,2,False
-2,40,136,138,2,False
-2,339,162,148,-14,False
-2,132,144,146,2,False
-2,431,170,140,-30,False
-2,224,152,154,2,False
-2,17,134,136,2,False
-2,316,160,150,-10,False
-2,109,142,144,2,False
-2,408,168,142,-26,False
-2,201,150,152,2,False
-2,500,176,134,-42,False
-2,293,158,152,-6,False
-2,86,140,142,2,False
-2,385,166,144,-22,False
-2,178,148,150,2,False
-2,477,174,136,-38,False
-2,270,156,154,-2,False
-2,63,138,140,2,False
-2,362,164,146,-18,False
-2,155,146,148,2,False
-2,454,172,138,-34,False
-2,247,154,156,2,False
-2,40,136,138,2,False
-2,339,162,148,-14,False
-2,132,144,146,2,False
-2,431,170,140,-30,False
-2,224,152,154,2,False
-2,17,134,136,2,False
-2,316,160,150,-10,False
-2,109,142,144,2,False
-2,408,168,142,-26,False
-2,201,150,152,2,False
-2,500,176,134,-42,False
-2,293,158,152,-6,False
-2,86,140,142,2,False
-2,385,166,144,-22,False
-2,178,148,150,2,False
-2,477,174,136,-38,False
-2,270,156,154,-2,False
-2,63,138,140,2,False
-2,362,164,146,-18,False
-2,155,146,148,2,False
-2,454,172,138,-34,False
-2,247,154,156,2,False
-2,40,136,138,2,False
-2,339,162,148,-14,False
-2,132,144,146,2,False
-2,431,170,140,-30,False
-2,224,152,154,2,False
-2,17,134,136,2,False
-2,316,160,150,-10,False
-2,109,142,144,2,False
-2,408,168,142,-26,False
-2,201,150,152,2,False
-2,500,176,134,-42,False
-2,293,158,152,-6,False
-2,86,140,142,2,False
-2,385,166,144,-22,False
-2,178,148,150,2,False
-2,477,174,136,-38,False
-2,270,156,154,-2,False
-2,63,138,140,2,False
-2,362,164,146,-18,False
-2,155,146,148,2,False
-2,454,172,138,-34,False
-2,247,154,156,2,False
-2,40,136,138,2,False
-2,339,162,148,-14,False
-2,132,144,146,2,False
-2,431,170,140,-30,False
-2,224,152,154,2,False
-2,17,134,136,2,False
-2,316,160,150,-10,False
-2,109,142,144,2,False
-2,408,168,142,-26,False
-2,201,150,152,2,False
-2,500,176,134,-42,False
-2,293,158,152,-6,False
-2,86,140,142,2,False
-2,385,166,144,-22,False
-2,178,148,150,2,False
-2,477,174,136,-38,False
-2,270,156,154,-2,False
-2,63,138,140,2,False
-2,362,164,146,-18,False
-2,155,146,148,2,False
-2,454,172,138,-34,False
-2,247,154,156,2,False
-2,40,136,138,2,False
-2,339,162,148,-14,False
-2,132,144,146,2,False
-2,431,170,140,-30,False
-2,224,152,154,2,False
-2,17,134,136,2,False
-2,316,160,150,-10,False
-2,109,142,144,2,False
-2,408,168,142,-26,False
-2,201,150,152,2,False
-2,500,176,134,-42,False
-2,293,158,152,-6,False
-2,86,140,142,2,False
-2,385,166,144,-22,False
-2,178,148,150,2,False
-2,477,174,136,-38,False
-2,270,156,154,-2,False
-2,63,138,140,2,False
-2,362,164,146,-18,False
-2,155,146,148,2,False
-2,454,172,138,-34,False
-2,247,154,156,2,False
-2,40,136,138,2,False
-2,339,162,148,-14,False
-2,132,144,146,2,False
-2,431,170,140,-30,False
-2,224,152,154,2,False
-2,17,134,136,2,False
-2,316,160,150,-10,False
-2,109,142,144,2,False
-2,408,168,142,-26,False
-2,201,150,152,2,False
-2,500,176,134,-42,False
-2,293,158,152,-6,False
-2,86,140,142,2,False
-2,385,166,144,-22,False
-2,178,148,150,2,False
-2,477,174,136,-38,False
-2,270,156,154,-2,False
-2,63,138,140,2,False
-2,362,164,146,-18,False
-2,155,146,148,2,False
-2,454,172,138,-34,False
-2,247,154,156,2,False
-2,40,136,138,2,False
-2,339,162,148,-14,False
-2,132,144,146,2,False
-2,431,170,140,-30,False
-2,224,152,154,2,False
-2,17,134,136,2,False
-2,316,160,150,-10,False
-2,109,142,144,2,False
-2,408,168,142,-26,False
-2,201,150,152,2,False
-2,500,176,134,-42,False
-2,293,158,152,-6,False
-2,86,140,142,2,False
-2,385,166,144,-22,False
-2,178,148,150,2,False
-2,477,174,136,-38,False
-2,270,156,154,-2,False
-2,63,138,140,2,False
-2,362,164,146,-18,False
-2,155,146,148,2,False
-2,454,172,138,-34,False
-2,247,154,156,2,False
-2,40,136,138,2,False
-2,339,162,148,-14,False
-2,132,144,146,2,False
-2,431,170,140,-30,False
-2,224,152,154,2,False
-2,17,134,136,2,False
-2,316,160,150,-10,False
-2,109,142,144,2,False
-2,408,168,142,-26,False
-2,201,150,152,2,False
-2,500,176,134,-42,False
-2,293,158,152,-6,False
-2,86,140,142,2,False
-2,385,166,144,-22,False
-2,178,148,150,2,False
-2,477,174,136,-38,False
-2,270,156,154,-2,False
-2,63,138,140,2,False
-2,362,164,146,-18,False
-2,155,146,148,2,False
-2,454,172,138,-34,False
-2,247,154,156,2,False
-2,40,136,138,2,False
-2,339,162,148,-14,False
-2,132,144,146,2,False
-2,431,170,140,-30,False
-2,224,152,154,2,False
-2,17,134,136,2,False
-2,316,160,150,-10,False
-2,109,142,144,2,False
-2,408,168,142,-26,False
-2,201,150,152,2,False
-2,500,176,134,-42,False
-2,293,158,152,-6,False
-2,86,140,142,2,False
-2,385,166,144,-22,False
-2,178,148,150,2,False
-2,477,174,136,-38,False
-2,270,156,154,-2,False
-2,63,138,140,2,False
-2,362,164,146,-18,False
-2,155,146,148,2,False
-2,454,172,138,-34,False
-2,247,154,156,2,False
-2,40,136,138,2,False
-2,339,162,148,-14,False
-2,132,144,146,2,False
-2,431,170,140,-30,False
-2,224,152,154,2,False
-2,17,134,136,2,False
-2,316,160,150,-10,False
-2,109,142,144,2,False
-2,408,168,142,-26,False
-2,201,150,152,2,False
-2,500,176,134,-42,False
-2,293,158,152,-6,False
-2,86,140,142,2,False
-2,385,166,144,-22,False
-2,178,148,150,2,False
-2,477,174,136,-38,False
-2,270,156,154,-2,False
-2,63,138,140,2,False
-2,362,164,146,-18,False
-2,155,146,148,2,False
-2,454,172,138,-34,False
-2,247,154,156,2,False
-2,40,136,138,2,False
-2,339,162,148,-14,False
-2,132,144,146,2,False
-2,431,170,140,-30,False
-2,224,152,154,2,False
-2,17,134,136,2,False
-2,316,160,150,-10,False
-2,109,142,144,2,False
-2,408,168,142,-26,False
-2,201,150,152,2,False
-2,500,176,134,-42,False
-2,293,158,152,-6,False
-2,86,140,142,2,False
-2,385,166,144,-22,False
-2,178,148,150,2,False
-2,477,174,136,-38,False
-2,270,156,154,-2,False
-2,63,138,140,2,False
-2,362,164,146,-18,False
-2,155,146,148,2,False
-2,454,172,138,-34,False
-2,247,154,156,2,False
-2,40,136,138,2,False
-2,339,162,148,-14,False
-2,132,144,146,2,False
-2,431,170,140,-30,False
-2,224,152,154,2,False
-2,17,134,136,2,False
-2,316,160,150,-10,False
-2,109,142,144,2,False
-2,408,168,142,-26,False
-2,201,150,152,2,False
-2,500,176,134,-42,False
-2,293,158,152,-6,False
-2,86,140,142,2,False
-2,385,166,144,-22,False
-2,178,148,150,2,False
-2,477,174,136,-38,False
-2,270,156,154,-2,False
-2,63,138,140,2,False
-2,362,164,146,-18,False
-2,155,146,148,2,False
-2,454,172,138,-34,False
-2,247,154,156,2,False
-2,40,136,138,2,False
-2,339,162,148,-14,False
-2,132,144,146,2,False
-2,431,170,140,-30,False
-2,224,152,154,2,False
-2,17,134,136,2,False
-2,316,160,150,-10,False
-2,109,142,144,2,False
-2,408,168,142,-26,False
-2,201,150,152,2,False
-2,500,176,134,-42,False
-2,293,158,152,-6,False
-2,86,140,142,2,False
-2,385,166,144,-22,False
-2,178,148,150,2,False
-2,477,174,136,-38,False
-2,270,156,154,-2,False
-2,63,138,140,2,False
-2,362,164,146,-18,False
-2,155,146,148,2,False
-2,454,172,138,-34,False
-2,247,154,156,2,False
-2,40,136,138,2,False
-2,339,162,148,-14,False
-2,132,144,146,2,False
-2,431,170,140,-30,False
-2,224,152,154,2,False
-2,17,134,136,2,False
-2,316,160,150,-10,False
-2,109,142,144,2,False
-2,408,168,142,-26,False
-2,201,150,152,2,False
-2,500,176,134,-42,False
-2,293,158,152,-6,False
-2,86,140,142,2,False
-2,385,166,144,-22,False
-2,178,148,150,2,False
-2,477,174,136,-38,False
-2,270,156,154,-2,False
-2,63,138,140,2,False
-2,362,164,146,-18,False
-2,155,146,148,2,False
-2,454,172,138,-34,False
-2,247,154,156,2,False
-2,40,136,138,2,False
-2,339,162,148,-14,False
-2,132,144,146,2,False
-2,431,170,140,-30,False
-2,224,152,154,2,False
-2,17,134,136,2,False
-2,316,160,150,-10,False
-2,109,142,144,2,False
-2,408,168,142,-26,False
-2,201,150,152,2,False
-2,500,176,134,-42,False
-2,293,158,152,-6,False
-2,86,140,142,2,False
-2,385,166,144,-22,False
-2,178,148,150,2,False
-2,477,174,136,-38,False
-2,270,156,154,-2,False
-2,63,138,140,2,False
-2,362,164,146,-18,False
-2,155,146,148,2,False
-2,454,172,138,-34,False
-2,247,154,156,2,False
-2,40,136,138,2,False
-2,339,162,148,-14,False
-2,132,144,146,2,False
-2,431,170,140,-30,False
-2,224,152,154,2,False
-2,17,134,136,2,False
-2,316,160,150,-10,False
-2,109,142,144,2,False
-2,408,168,142,-26,False
-2,201,150,152,2,False
-2,500,176,134,-42,False
-2,293,158,152,-6,False
-2,86,140,142,2,False
-2,385,166,144,-22,False
-2,178,148,150,2,False
-2,477,174,136,-38,False
-2,270,156,154,-2,False
-2,63,138,140,2,False
-2,362,164,146,-18,False
-2,155,146,148,2,False
-2,454,172,138,-34,False
-2,247,154,156,2,False
-2,40,136,138,2,False
-2,339,162,148,-14,False
-2,132,144,146,2,False
-2,431,170,140,-30,False
-2,224,152,154,2,False
-2,17,134,136,2,False
-2,316,160,150,-10,False
-2,109,142,144,2,False
-2,408,168,142,-26,False
-2,201,150,152,2,False
-2,500,176,134,-42,False
-2,293,158,152,-6,False
-2,86,140,142,2,False
-2,385,166,144,-22,False
-2,178,148,150,2,False
-2,477,174,136,-38,False
-2,270,156,154,-2,False
-2,63,138,140,2,False
-2,362,164,146,-18,False
-2,155,146,148,2,False
-2,454,172,138,-34,False
-2,247,154,156,2,False
-2,40,136,138,2,False
-2,339,162,148,-14,False
-2,132,144,146,2,False
-2,431,170,140,-30,False
-2,224,152,154,2,False
-2,17,134,136,2,False
-2,316,160,150,-10,False
-2,109,142,144,2,False
-2,408,168,142,-26,False
-2,201,150,152,2,False
-2,500,176,134,-42,False
-2,293,158,152,-6,False
-2,86,140,142,2,False
-2,385,166,144,-22,False
-2,178,148,150,2,False
-2,477,174,136,-38,False
-2,270,156,154,-2,False
-2,63,138,140,2,False
-2,362,164,146,-18,False
-2,155,146,148,2,False
-2,454,172,138,-34,False
-2,247,154,156,2,False
-2,40,136,138,2,False
-2,339,162,148,-14,False
-2,132,144,146,2,False
-2,431,170,140,-30,False
-2,224,152,154,2,False
-2,17,134,136,2,False
-2,316,160,150,-10,False
-2,109,142,144,2,False
-2,408,168,142,-26,False
-2,201,150,152,2,False
-2,500,176,134,-42,False
-2,293,158,152,-6,False
-2,86,140,142,2,False
-2,385,166,144,-22,False
-2,178,148,150,2,False
-2,477,174,136,-38,False
-2,270,156,154,-2,False
-2,63,138,140,2,False
-2,362,164,146,-18,False
-2,155,146,148,2,False
-2,454,172,138,-34,False
-2,247,154,156,2,False
-2,40,136,138,2,False
-2,339,162,148,-14,False
-2,132,144,146,2,False
-2,431,170,140,-30,False
-2,224,152,154,2,False
-2,17,134,136,2,False
-2,316,160,150,-10,False
-2,109,142,144,2,False
-2,408,168,142,-26,False
-2,201,150,152,2,False
-2,500,176,134,-42,False
-2,293,158,152,-6,False
-2,86,140,142,2,False
-2,385,166,144,-22,False
-2,178,148,150,2,False
-2,477,174,136,-38,False
-2,270,156,154,-2,False
-2,63,138,140,2,False
-2,362,164,146,-18,False
-2,155,146,148,2,False
-2,454,172,138,-34,False
-2,247,154,156,2,False
-2,40,136,138,2,False
-2,339,162,148,-14,False
-2,132,144,146,2,False
-2,431,170,140,-30,False
-2,224,152,154,2,False
-2,17,134,136,2,False
-2,316,160,150,-10,False
-2,109,142,144,2,False
-2,408,168,142,-26,False
-2,201,150,152,2,False
-2,500,176,134,-42,False
-2,293,158,152,-6,False
-2,86,140,142,2,False
-2,385,166,144,-22,False
-2,178,148,150,2,False
-2,477,174,136,-38,False
-2,270,156,154,-2,False
-2,63,138,140,2,False
-2,362,164,146,-18,False
-2,155,146,148,2,False
-2,454,172,138,-34,False
-2,247,154,156,2,False
-2,40,136,138,2,False
-2,339,162,148,-14,False
-2,132,144,146,2,False
-2,431,170,140,-30,False
-2,224,152,154,2,False
-2,17,134,136,2,False
-2,316,160,150,-10,False
-2,109,142,144,2,False
-2,408,168,142,-26,False
-2,201,150,152,2,False
-2,500,176,134,-42,False
-2,293,158,152,-6,False
-2,86,140,142,2,False
-2,385,166,144,-22,False
-2,178,148,150,2,False
-2,477,174,136,-38,False
-2,270,156,154,-2,False
-2,63,138,140,2,False
-2,362,164,146,-18,False
-2,155,146,148,2,False
-2,454,172,138,-34,False
-2,247,154,156,2,False
-2,40,136,138,2,False
-2,339,162,148,-14,False
-2,132,144,146,2,False
-2,431,170,140,-30,False
-2,224,152,154,2,False
-2,17,134,136,2,False
-2,316,160,150,-10,False
-2,109,142,144,2,False
-2,408,168,142,-26,False
-2,201,150,152,2,False
-2,500,176,134,-42,False
-2,293,158,152,-6,False
-2,86,140,142,2,False
-2,385,166,144,-22,False
-2,178,148,150,2,False
-2,477,174,136,-38,False
-2,270,156,154,-2,False
-2,63,138,140,2,False
-2,362,164,146,-18,False
-2,155,146,148,2,False
-2,454,172,138,-34,False
-2,247,154,156,2,False
-2,40,136,138,2,False
-2,339,162,148,-14,False
-2,132,144,146,2,False
-2,431,170,140,-30,False
-2,224,152,154,2,False
-2,17,134,136,2,False
-2,316,160,150,-10,False
-2,109,142,144,2,False
-2,408,168,142,-26,False
-2,201,150,152,2,False
-2,500,176,134,-42,False
-2,293,158,152,-6,False
-2,86,140,142,2,False
-2,385,166,144,-22,False
-2,178,148,150,2,False
-2,477,174,136,-38,False
-2,270,156,154,-2,False
-2,63,138,140,2,False
-2,362,164,146,-18,False
-2,155,146,148,2,False
-2,454,172,138,-34,False
-2,247,154,156,2,False
-2,40,136,138,2,False
-2,339,162,148,-14,False
-2,132,144,146,2,False
-2,431,170,140,-30,False
-2,224,152,154,2,False
-2,17,134,136,2,False
-2,316,160,150,-10,False
-2,109,142,144,2,False
-2,408,168,142,-26,False
-2,201,150,152,2,False
-2,500,176,134,-42,False
-2,293,158,152,-6,False
-2,86,140,142,2,False
-2,385,166,144,-22,False
-2,178,148,150,2,False
-2,477,174,136,-38,False
-2,270,156,154,-2,False
-2,63,138,140,2,False
-2,362,164,146,-18,False
-2,155,146,148,2,False
-2,454,172,138,-34,False
-2,247,154,156,2,False
-2,40,136,138,2,False
-2,339,162,148,-14,False
-2,132,144,146,2,False
-2,431,170,140,-30,False
-2,224,152,154,2,False
-2,17,134,136,2,False
-2,316,160,150,-10,False
-2,109,142,144,2,False
-2,408,168,142,-26,False
-2,201,150,152,2,False
-2,500,176,134,-42,False
-2,293,158,152,-6,False
-2,86,140,142,2,False
-2,385,166,144,-22,False
-2,178,148,150,2,False
-2,477,174,136,-38,False
-2,270,156,154,-2,False
-2,63,138,140,2,False
-2,362,164,146,-18,False
-2,155,146,148,2,False
-2,454,172,138,-34,False
-2,247,154,156,2,False
-2,40,136,138,2,False
-2,339,162,148,-14,False
-2,132,144,146,2,False
-2,431,170,140,-30,False
-2,224,152,154,2,False
-2,17,134,136,2,False
-2,316,160,150,-10,False
-2,109,142,144,2,False
-2,408,168,142,-26,False
-2,201,150,152,2,False
-2,500,176,134,-42,False
-2,293,158,152,-6,False
-2,86,140,142,2,False
-2,385,166,144,-22,False
-2,178,148,150,2,False
-2,477,174,136,-38,False
-2,270,156,154,-2,False
-2,63,138,140,2,False
-2,362,164,146,-18,False
-2,155,146,148,2,False
-2,454,172,138,-34,False
-2,247,154,156,2,False
-2,40,136,138,2,False
-2,339,162,148,-14,False
-2,132,144,146,2,False
-2,431,170,140,-30,False
-2,224,152,154,2,False
-2,17,134,136,2,False
-2,316,160,150,-10,False
-2,109,142,144,2,False
-2,408,168,142,-26,False
-2,201,150,152,2,False
-2,500,176,134,-42,False
-2,293,158,152,-6,False
-2,86,140,142,2,False
-2,385,166,144,-22,False
-2,178,148,150,2,False
-2,477,174,136,-38,False
-2,270,156,154,-2,False
-2,63,138,140,2,False
-2,362,164,146,-18,False
-2,155,146,148,2,False
-2,454,172,138,-34,False
-2,247,154,156,2,False
-2,40,136,138,2,False
-2,339,162,148,-14,False
-2,132,144,146,2,False
-2,431,170,140,-30,False
-2,224,152,154,2,False
-2,17,134,136,2,False
-2,316,160,150,-10,False
-2,109,142,144,2,False
-2,408,168,142,-26,False
-2,201,150,152,2,False
-2,500,176,134,-42,False
-2,293,158,152,-6,False
-2,86,140,142,2,False
-2,385,166,144,-22,False
-2,178,148,150,2,False
-2,477,174,136,-38,False
-2,270,156,154,-2,False
-2,63,138,140,2,False
-2,362,164,146,-18,False
-2,155,146,148,2,False
-2,454,172,138,-34,False
-2,247,154,156,2,False
-2,40,136,138,2,False
-2,339,162,148,-14,False
-2,132,144,146,2,False
-2,431,170,140,-30,False
-2,224,152,154,2,False
-2,17,134,136,2,False
-2,316,160,150,-10,False
-2,109,142,144,2,False
-2,408,168,142,-26,False
-2,201,150,152,2,False
-2,500,176,134,-42,False
-2,293,158,152,-6,False
-2,86,140,142,2,False
-2,385,166,144,-22,False
-2,178,148,150,2,False
-2,477,174,136,-38,False
-2,270,156,154,-2,False
-2,63,138,140,2,False
-2,362,164,146,-18,False
-2,155,146,148,2,False
-2,454,172,138,-34,False
-2,247,154,156,2,False
-2,40,136,138,2,False
-2,339,162,148,-14,False
-2,132,144,146,2,False
-2,431,170,140,-30,False
-2,224,152,154,2,False
-2,17,134,136,2,False
-2,316,160,150,-10,False
-2,109,142,144,2,False
-2,408,168,142,-26,False
-2,201,150,152,2,False
-2,500,176,134,-42,False
-2,293,158,152,-6,False
-2,86,140,142,2,False
-2,385,166,144,-22,False
-2,178,148,150,2,False
-2,477,174,136,-38,False
-2,270,156,154,-2,False
-2,63,138,140,2,False
-2,362,164,146,-18,False
-2,155,146,148,2,False
-2,454,172,138,-34,False
-2,247,154,156,2,False
-2,40,136,138,2,False
-2,339,162,148,-14,False
-2,132,144,146,2,False
-2,431,170,140,-30,False
-2,224,152,154,2,False
-2,17,134,136,2,False
-2,316,160,150,-10,False
-2,109,142,144,2,False
-2,408,168,142,-26,False
-2,201,150,152,2,False
-2,500,176,134,-42,False
-2,293,158,152,-6,False
-2,86,140,142,2,False
-2,385,166,144,-22,False
-2,178,148,150,2,False
-2,477,174,136,-38,False
-2,270,156,154,-2,False
-2,63,138,140,2,False
-2,362,164,146,-18,False
-2,155,146,148,2,False
-2,454,172,138,-34,False
-2,247,154,156,2,False
-2,40,136,138,2,False
-2,339,162,148,-14,False
-2,132,144,146,2,False
-2,431,170,140,-30,False
-2,224,152,154,2,False
-2,17,134,136,2,False
-2,316,160,150,-10,False
-2,109,142,144,2,False
-2,408,168,142,-26,False
-2,201,150,152,2,False
-2,500,176,134,-42,False
-2,293,158,152,-6,False
-2,86,140,142,2,False
-2,385,166,144,-22,False
-2,178,148,150,2,False
-2,477,174,136,-38,False
-2,270,156,154,-2,False
-2,63,138,140,2,False
-2,362,164,146,-18,False
-2,155,146,148,2,False
-2,454,172,138,-34,False
-2,247,154,156,2,False
-2,40,136,138,2,False
-2,339,162,148,-14,False
-2,132,144,146,2,False
-2,431,170,140,-30,False
-2,224,152,154,2,False
-2,17,134,136,2,False
-2,316,160,150,-10,False
-2,109,142,144,2,False
-2,408,168,142,-26,False
-2,201,150,152,2,False
-2,500,176,134,-42,False
-2,293,158,152,-6,False
-2,86,140,142,2,False
-2,385,166,144,-22,False
-2,178,148,150,2,False
-2,477,174,136,-38,False
-2,270,156,154,-2,False
-2,63,138,140,2,False
-2,362,164,146,-18,False
-2,155,146,148,2,False
-2,454,172,138,-34,False
-2,247,154,156,2,False
-2,40,136,138,2,False
-2,339,162,148,-14,False
-2,132,144,146,2,False
-2,431,170,140,-30,False
-2,224,152,154,2,False
-2,17,134,136,2,False
-2,316,160,150,-10,False
-2,109,142,144,2,False
-2,408,168,142,-26,False
-2,201,150,152,2,False
-2,500,176,134,-42,False
-2,293,158,152,-6,False
-2,86,140,142,2,False
-2,385,166,144,-22,False
-2,178,148,150,2,False
-2,477,174,136,-38,False
-2,270,156,154,-2,False
-2,63,138,140,2,False
-2,362,164,146,-18,False
-2,155,146,148,2,False
-2,454,172,138,-34,False
-2,247,154,156,2,False
-2,40,136,138,2,False
-2,339,162,148,-14,False
-2,132,144,146,2,False
-2,431,170,140,-30,False
-2,224,152,154,2,False
-2,17,134,136,2,False
-2,316,160,150,-10,False
-2,109,142,144,2,False
-2,408,168,142,-26,False
-2,201,150,152,2,False
-2,500,176,134,-42,False
-2,293,158,152,-6,False
-2,86,140,142,2,False
-2,385,166,144,-22,False
-2,178,148,150,2,False
-2,477,174,136,-38,False
-2,270,156,154,-2,False
-2,63,138,140,2,False
-2,362,164,146,-18,False
-2,155,146,148,2,False
-2,454,172,138,-34,False
-2,247,154,156,2,False
-2,40,136,138,2,False
-2,339,162,148,-14,False
-2,132,144,146,2,False
-2,431,170,140,-30,False
-2,224,152,154,2,False
-2,17,134,136,2,False
-2,316,160,150,-10,False
-2,109,142,144,2,False
-2,408,168,142,-26,False
-2,201,150,152,2,False
-2,500,176,134,-42,False
-2,293,158,152,-6,False
-2,86,140,142,2,False
-2,385,166,144,-22,False
-2,178,148,150,2,False
-2,477,174,136,-38,False
-2,270,156,154,-2,False
-2,63,138,140,2,False
-2,362,164,146,-18,False
-2,155,146,148,2,False
-2,454,172,138,-34,False
-2,247,154,156,2,False
-2,40,136,138,2,False
-2,339,162,148,-14,False
-2,132,144,146,2,False
-2,431,170,140,-30,False
-2,224,152,154,2,False
-2,17,134,136,2,False
-2,316,160,150,-10,False
-2,109,142,144,2,False
-2,408,168,142,-26,False
-2,201,150,152,2,False
-2,500,176,134,-42,False
-2,293,158,152,-6,False
-2,86,140,142,2,False
-2,385,166,144,-22,False
-2,178,148,150,2,False
-2,477,174,136,-38,False
-2,270,156,154,-2,False
-2,63,138,140,2,False
-2,362,164,146,-18,False
-2,155,146,148,2,False
-2,454,172,138,-34,False
-2,247,154,156,2,False
-2,40,136,138,2,False
-2,339,162,148,-14,False
-2,132,144,146,2,False
-2,431,170,140,-30,False
-2,224,152,154,2,False
-2,17,134,136,2,False
-2,316,160,150,-10,False
-2,109,142,144,2,False
-2,408,168,142,-26,False
-2,201,150,152,2,False
-2,500,176,134,-42,False
-2,293,158,152,-6,False
-2,86,140,142,2,False
-2,385,166,144,-22,False
-2,178,148,150,2,False
-2,477,174,136,-38,False
-2,270,156,154,-2,False
-2,63,138,140,2,False
-2,362,164,146,-18,False
-2,155,146,148,2,False
-2,454,172,138,-34,False
-2,247,154,156,2,False
-2,40,136,138,2,False
-2,339,162,148,-14,False
-2,132,144,146,2,False
-2,431,170,140,-30,False
-2,224,152,154,2,False
-2,17,134,136,2,False
-2,316,160,150,-10,False
-2,109,142,144,2,False
-2,408,168,142,-26,False
-2,201,150,152,2,False
-2,500,176,134,-42,False
-2,293,158,152,-6,False
-2,86,140,142,2,False
-2,385,166,144,-22,False
-2,178,148,150,2,False
-2,477,174,136,-38,False
-2,270,156,154,-2,False
-2,63,138,140,2,False
-2,362,164,146,-18,False
-2,155,146,148,2,False
-2,454,172,138,-34,False
-2,247,154,156,2,False
-2,40,136,138,2,False
-2,339,162,148,-14,False
-2,132,144,146,2,False
-2,431,170,140,-30,False
-2,224,152,154,2,False
-2,17,134,136,2,False
-2,316,160,150,-10,False
-2,109,142,144,2,False
-2,408,168,142,-26,False
-2,201,150,152,2,False
-2,500,176,134,-42,False
-2,293,158,152,-6,False
-2,86,140,142,2,False
-2,385,166,144,-22,False
-2,178,148,150,2,False
-2,477,174,136,-38,False
-2,270,156,154,-2,False
-2,63,138,140,2,False
-2,362,164,146,-18,False
-2,155,146,148,2,False
-2,454,172,138,-34,False
-2,247,154,156,2,False
-2,40,136,138,2,False
-2,339,162,148,-14,False
-2,132,144,146,2,False
-2,431,170,140,-30,False
-2,224,152,154,2,False
-2,17,134,136,2,False
-2,316,160,150,-10,False
-2,109,142,144,2,False
-2,408,168,142,-26,False
-2,201,150,152,2,False
-2,500,176,134,-42,False
-2,293,158,152,-6,False
-2,86,140,142,2,False
-2,385,166,144,-22,False
-2,178,148,150,2,False
-2,477,174,136,-38,False
-2,270,156,154,-2,False
-2,63,138,140,2,False
-2,362,164,146,-18,False
-2,155,146,148,2,False
-2,454,172,138,-34,False
-2,247,154,156,2,False
-2,40,136,138,2,False
-2,339,162,148,-14,False
-2,132,144,146,2,False
-2,431,170,140,-30,False
-2,224,152,154,2,False
-2,17,134,136,2,False
-2,316,160,150,-10,False
-2,109,142,144,2,False
-2,408,168,142,-26,False
-2,201,150,152,2,False
-2,500,176,134,-42,False
-2,293,158,152,-6,False
-2,86,140,142,2,False
-2,385,166,144,-22,False
-2,178,148,150,2,False
-2,477,174,136,-38,False
-2,270,156,154,-2,False
-2,63,138,140,2,False
-2,362,164,146,-18,False
-2,155,146,148,2,False
-2,454,172,138,-34,False
-2,247,154,156,2,False
-2,40,136,138,2,False
-2,339,162,148,-14,False
-2,132,144,146,2,False
-2,431,170,140,-30,False
-2,224,152,154,2,False
-2,17,134,136,2,False
-2,316,160,150,-10,False
-2,109,142,144,2,False
-2,408,168,142,-26,False
-2,201,150,152,2,False
-2,500,176,134,-42,False
-2,293,158,152,-6,False
-2,86,140,142,2,False
-2,385,166,144,-22,False
-2,178,148,150,2,False
-2,477,174,136,-38,False
-2,270,156,154,-2,False
-2,63,138,140,2,False
-2,362,164,146,-18,False
-2,155,146,148,2,False
-2,454,172,138,-34,False
-2,247,154,156,2,False
-2,40,136,138,2,False
-2,339,162,148,-14,False
-2,132,144,146,2,False
-2,431,170,140,-30,False
-2,224,152,154,2,False
-2,17,134,136,2,False
-2,316,160,150,-10,False
-2,109,142,144,2,False
-2,408,168,142,-26,False
-2,201,150,152,2,False
-2,500,176,134,-42,False
-2,293,158,152,-6,False
-2,86,140,142,2,False
-2,385,166,144,-22,False
-2,178,148,150,2,False
-2,477,174,136,-38,False
-2,270,156,154,-2,False
-2,63,138,140,2,False
-2,362,164,146,-18,False
-2,155,146,148,2,False
-2,454,172,138,-34,False
-2,247,154,156,2,False
-2,40,136,138,2,False
-2,339,162,148,-14,False
-2,132,144,146,2,False
-2,431,170,140,-30,False
-2,224,152,154,2,False
-2,17,134,136,2,False
-2,316,160,150,-10,False
-2,109,142,144,2,False
-2,408,168,142,-26,False
-2,201,150,152,2,False
-2,500,176,134,-42,False
-2,293,158,152,-6,False
-2,86,140,142,2,False
-2,385,166,144,-22,False
-2,178,148,150,2,False
-2,477,174,136,-38,False
-2,270,156,154,-2,False
-2,63,138,140,2,False
-2,362,164,146,-18,False
-2,155,146,148,2,False
-2,454,172,138,-34,False
-2,247,154,156,2,False
-2,40,136,138,2,False
-2,339,162,148,-14,False
-2,132,144,146,2,False
-2,431,170,140,-30,False
-2,224,152,154,2,False
-2,17,134,136,2,False
-2,316,160,150,-10,False
-2,109,142,144,2,False
-2,408,168,142,-26,False
-2,201,150,152,2,False
-2,500,176,134,-42,False
-2,293,158,152,-6,False
-2,86,140,142,2,False
-2,385,166,144,-22,False
-2,178,148,150,2,False
-2,477,174,136,-38,False
-2,270,156,154,-2,False
-2,63,138,140,2,False
-2,362,164,146,-18,False
-2,155,146,148,2,False
-2,454,172,138,-34,False
-2,247,154,156,2,False
-2,40,136,138,2,False
-2,339,162,148,-14,False
-2,132,144,146,2,False
-2,431,170,140,-30,False
-2,224,152,154,2,False
-2,17,134,136,2,False
-2,316,160,150,-10,False
-2,109,142,144,2,False
-2,408,168,142,-26,False
-2,201,150,152,2,False
-2,500,176,134,-42,False
-2,293,158,152,-6,False
-2,86,140,142,2,False
-2,385,166,144,-22,False
-2,178,148,150,2,False
-2,477,174,136,-38,False
-2,270,156,154,-2,False
-2,63,138,140,2,False
-2,362,164,146,-18,False
-2,155,146,148,2,False
-2,454,172,138,-34,False
-2,247,154,156,2,False
-2,40,136,138,2,False
-2,339,162,148,-14,False
-2,132,144,146,2,False
-2,431,170,140,-30,False
-2,224,152,154,2,False
-2,17,134,136,2,False
-2,316,160,150,-10,False
-2,109,142,144,2,False
-2,408,168,142,-26,False
-2,201,150,152,2,False
-2,500,176,134,-42,False
-2,293,158,152,-6,False
-2,86,140,142,2,False
-2,385,166,144,-22,False
-2,178,148,150,2,False
-2,477,174,136,-38,False
-2,270,156,154,-2,False
-2,63,138,140,2,False
-2,362,164,146,-18,False
-2,155,146,148,2,False
-2,454,172,138,-34,False
-2,247,154,156,2,False
-2,40,136,138,2,False
-2,339,162,148,-14,False
-2,132,144,146,2,False
-2,431,170,140,-30,False
-2,224,152,154,2,False
-2,17,134,136,2,False
-2,316,160,150,-10,False
-2,109,142,144,2,False
-2,408,168,142,-26,False
-2,201,150,152,2,False
-2,500,176,134,-42,False
-2,293,158,152,-6,False
-2,86,140,142,2,False
-2,385,166,144,-22,False
-2,178,148,150,2,False
-2,477,174,136,-38,False
-2,270,156,154,-2,False
-2,63,138,140,2,False
-2,362,164,146,-18,False
-2,155,146,148,2,False
-2,454,172,138,-34,False
-2,247,154,156,2,False
-2,40,136,138,2,False
-2,339,162,148,-14,False
-2,132,144,146,2,False
-2,431,170,140,-30,False
-2,224,152,154,2,False
-2,17,134,136,2,False
-2,316,160,150,-10,False
-2,109,142,144,2,False
-2,408,168,142,-26,False
-2,201,150,152,2,False
-2,500,176,134,-42,False
-2,293,158,152,-6,False
-2,86,140,142,2,False
-2,385,166,144,-22,False
-2,178,148,150,2,False
-2,477,174,136,-38,False
-2,270,156,154,-2,False
-2,63,138,140,2,False
-2,362,164,146,-18,False
-2,155,146,148,2,False
-2,454,172,138,-34,False
-2,247,154,156,2,False
-2,40,136,138,2,False
-2,339,162,148,-14,False
-2,132,144,146,2,False
-2,431,170,140,-30,False
-2,224,152,154,2,False
-2,17,134,136,2,False
-2,316,160,150,-10,False
-2,109,142,144,2,False
-2,408,168,142,-26,False
-2,201,150,152,2,False
-2,500,176,134,-42,False
-2,293,158,152,-6,False
-2,86,140,142,2,False
-2,385,166,144,-22,False
-2,178,148,150,2,False
-2,477,174,136,-38,False
-2,270,156,154,-2,False
-2,63,138,140,2,False
-2,362,164,146,-18,False
-2,155,146,148,2,False
-2,454,172,138,-34,False
-2,247,154,156,2,False
-2,40,136,138,2,False
-2,339,162,148,-14,False
-2,132,144,146,2,False
-2,431,170,140,-30,False
-2,224,152,154,2,False
-2,17,134,136,2,False
-2,316,160,150,-10,False
-2,109,142,144,2,False
-2,408,168,142,-26,False
-2,201,150,152,2,False
-2,500,176,134,-42,False
-2,293,158,152,-6,False
-2,86,140,142,2,False
-2,385,166,144,-22,False
-2,178,148,150,2,False
-2,477,174,136,-38,False
-2,270,156,154,-2,False
-2,63,138,140,2,False
-2,362,164,146,-18,False
-2,155,146,148,2,False
-2,454,172,138,-34,False
-2,247,154,156,2,False
-2,40,136,138,2,False
-2,339,162,148,-14,False
-2,132,144,146,2,False
-2,431,170,140,-30,False
-2,224,152,154,2,False
-2,17,134,136,2,False
-2,316,160,150,-10,False
-2,109,142,144,2,False
-2,408,168,142,-26,False
-2,201,150,152,2,False
-2,500,176,134,-42,False
-2,293,158,152,-6,False
-2,86,140,142,2,False
-2,385,166,144,-22,False
-2,178,148,150,2,False
-2,477,174,136,-38,False
-2,270,156,154,-2,False
-2,63,138,140,2,False
-2,362,164,146,-18,False
-2,155,146,148,2,False
-2,454,172,138,-34,False
-2,247,154,156,2,False
-2,40,136,138,2,False
-2,339,162,148,-14,False
-2,132,144,146,2,False
-2,431,170,140,-30,False
-2,224,152,154,2,False
-2,17,134,136,2,False
-2,316,160,150,-10,False
-2,109,142,144,2,False
-2,408,168,142,-26,False
-2,201,150,152,2,False
-2,500,176,134,-42,False
-2,293,158,152,-6,False
-2,86,140,142,2,False
-2,385,166,144,-22,False
-2,178,148,150,2,False
-2,477,174,136,-38,False
-2,270,156,154,-2,False
-2,63,138,140,2,False
-2,362,164,146,-18,False
-2,155,146,148,2,False
-2,454,172,138,-34,False
-2,247,154,156,2,False
-2,40,136,138,2,False
-2,339,162,148,-14,False
-2,132,144,146,2,False
-2,431,170,140,-30,False
-2,224,152,154,2,False
-2,17,134,136,2,False
-2,316,160,150,-10,False
-2,109,142,144,2,False
-2,408,168,142,-26,False
-2,201,150,152,2,False
-2,500,176,134,-42,False
-2,293,158,152,-6,False
-2,86,140,142,2,False
-2,385,166,144,-22,False
-2,178,148,150,2,False
-2,477,174,136,-38,False
-2,270,156,154,-2,False
-2,63,138,140,2,False
-2,362,164,146,-18,False
-2,155,146,148,2,False
-2,454,172,138,-34,False
-2,247,154,156,2,False
-2,40,136,138,2,False
-2,339,162,148,-14,False
-2,132,144,146,2,False
-2,431,170,140,-30,False
-2,224,152,154,2,False
-2,17,134,136,2,False
-2,316,160,150,-10,False
-2,109,142,144,2,False
-2,408,168,142,-26,False
-2,201,150,152,2,False
-2,500,176,134,-42,False
-2,293,158,152,-6,False
-2,86,140,142,2,False
-2,385,166,144,-22,False
-2,178,148,150,2,False
-2,477,174,136,-38,False
-2,270,156,154,-2,False
-2,63,138,140,2,False
-2,362,164,146,-18,False
-2,155,146,148,2,False
-2,454,172,138,-34,False
-2,247,154,156,2,False
-2,40,136,138,2,False
-2,339,162,148,-14,False
-2,132,144,146,2,False
-2,431,170,140,-30,False
-2,224,152,154,2,False
-2,17,134,136,2,False
-2,316,160,150,-10,False
-2,109,142,144,2,False
-2,408,168,142,-26,False
-2,201,150,152,2,False
-2,500,176,134,-42,False
-2,293,158,152,-6,False
-2,86,140,142,2,False
-2,385,166,144,-22,False
-2,178,148,150,2,False
-2,477,174,136,-38,False
-2,270,156,154,-2,False
-2,63,138,140,2,False
-2,362,164,146,-18,False
-2,155,146,148,2,False
-2,454,172,138,-34,False
-2,247,154,156,2,False
-2,40,136,138,2,False
-2,339,162,148,-14,False
-2,132,144,146,2,False
-2,431,170,140,-30,False
-2,224,152,154,2,False
-2,17,134,136,2,False
-2,316,160,150,-10,False
-2,109,142,144,2,False
-2,408,168,142,-26,False
-2,201,150,152,2,False
-2,500,176,134,-42,False
-2,293,158,152,-6,False
-2,86,140,142,2,False
-2,385,166,144,-22,False
-2,178,148,150,2,False
-2,477,174,136,-38,False
-2,270,156,154,-2,False
-2,63,138,140,2,False
-2,362,164,146,-18,False
-2,155,146,148,2,False
-2,454,172,138,-34,False
-2,247,154,156,2,False
-2,40,136,138,2,False
-2,339,162,148,-14,False
-2,132,144,146,2,False
-2,431,170,140,-30,False
-2,224,152,154,2,False
-2,17,134,136,2,False
-2,316,160,150,-10,False
-2,109,142,144,2,False
-2,408,168,142,-26,False
-2,201,150,152,2,False
-2,500,176,134,-42,False
-2,293,158,152,-6,False
-2,86,140,142,2,False
-2,385,166,144,-22,False
-2,178,148,150,2,False
-2,477,174,136,-38,False
-2,270,156,154,-2,False
-2,63,138,140,2,False
-2,362,164,146,-18,False
-2,155,146,148,2,False
-2,454,172,138,-34,False
-2,247,154,156,2,False
-2,40,136,138,2,False
-2,339,162,148,-14,False
-2,132,144,146,2,False
-2,431,170,140,-30,False
-2,224,152,154,2,False
-2,17,134,136,2,False
-2,316,160,150,-10,False
-2,109,142,144,2,False
-2,408,168,142,-26,False
-2,201,150,152,2,False
-2,500,176,134,-42,False
-2,293,158,152,-6,False
-2,86,140,142,2,False
-2,385,166,144,-22,False
-2,178,148,150,2,False
-2,477,174,136,-38,False
-2,270,156,154,-2,False
-2,63,138,140,2,False
-2,362,164,146,-18,False
-2,155,146,148,2,False
-2,454,172,138,-34,False
-2,247,154,156,2,False
-2,40,136,138,2,False
-2,339,162,148,-14,False
-2,132,144,146,2,False
-2,431,170,140,-30,False
-2,224,152,154,2,False
-2,17,134,136,2,False
-2,316,160,150,-10,False
-2,109,142,144,2,False
-2,408,168,142,-26,False
-2,201,150,152,2,False
-2,500,176,134,-42,False
-2,293,158,152,-6,False
-2,86,140,142,2,False
-2,385,166,144,-22,False
-2,178,148,150,2,False
-2,477,174,136,-38,False
-2,270,156,154,-2,False
-2,63,138,140,2,False
-2,362,164,146,-18,False
-2,155,146,148,2,False
-2,454,172,138,-34,False
-2,247,154,156,2,False
-2,40,136,138,2,False
-2,339,162,148,-14,False
-2,132,144,146,2,False
-2,431,170,140,-30,False
-2,224,152,154,2,False
-2,17,134,136,2,False
-2,316,160,150,-10,False
-2,109,142,144,2,False
-2,408,168,142,-26,False
-2,201,150,152,2,False
-2,500,176,134,-42,False
-2,293,158,152,-6,False
-2,86,140,142,2,False
-2,385,166,144,-22,False
-2,178,148,150,2,False
-2,477,174,136,-38,False
-2,270,156,154,-2,False
-2,63,138,140,2,False
-2,362,164,146,-18,False
-2,155,146,148,2,False
-2,454,172,138,-34,False
-2,247,154,156,2,False
-2,40,136,138,2,False
-2,339,162,148,-14,False
-2,132,144,146,2,False
-2,431,170,140,-30,False
-2,224,152,154,2,False
-2,17,134,136,2,False
-2,316,160,150,-10,False
-2,109,142,144,2,False
-2,408,168,142,-26,False
-2,201,150,152,2,False
-2,500,176,134,-42,False
-2,293,158,152,-6,False
-2,86,140,142,2,False
-2,385,166,144,-22,False
-2,178,148,150,2,False
-2,477,174,136,-38,False
-2,270,156,154,-2,False
-2,63,138,140,2,False
-2,362,164,146,-18,False
-2,155,146,148,2,False
-2,454,172,138,-34,False
-2,247,154,156,2,False
-2,40,136,138,2,False
-2,339,162,148,-14,False
-2,132,144,146,2,False
-2,431,170,140,-30,False
-2,224,152,154,2,False
-2,17,134,136,2,False
-2,316,160,150,-10,False
-2,109,142,144,2,False
-2,408,168,142,-26,False
-2,201,150,152,2,False
-2,500,176,134,-42,False
-2,293,158,152,-6,False
-2,86,140,142,2,False
-2,385,166,144,-22,False
-2,178,148,150,2,False
-2,477,174,136,-38,False
-2,270,156,154,-2,False
-2,63,138,140,2,False
-2,362,164,146,-18,False
-2,155,146,148,2,False
-2,454,172,138,-34,False
-2,247,154,156,2,False
-2,40,136,138,2,False
-2,339,162,148,-14,False
-2,132,144,146,2,False
-2,431,170,140,-30,False
-2,224,152,154,2,False
-2,17,134,136,2,False
-2,316,160,150,-10,False
-2,109,142,144,2,False
-2,408,168,142,-26,False
-2,201,150,152,2,False
-2,500,176,134,-42,False
-2,293,158,152,-6,False
-2,86,140,142,2,False
-2,385,166,144,-22,False
-2,178,148,150,2,False
-2,477,174,136,-38,False
-2,270,156,154,-2,False
-2,63,138,140,2,False
-2,362,164,146,-18,False
-2,155,146,148,2,False
-2,454,172,138,-34,False
-2,247,154,156,2,False
-2,40,136,138,2,False
-2,339,162,148,-14,False
-2,132,144,146,2,False
-2,431,170,140,-30,False
-2,224,152,154,2,False
-2,17,134,136,2,False
-2,316,160,150,-10,False
-2,109,142,144,2,False
-2,408,168,142,-26,False
-2,201,150,152,2,False
-2,500,176,134,-42,False
-2,293,158,152,-6,False
-2,86,140,142,2,False
-2,385,166,144,-22,False
-2,178,148,150,2,False
-2,477,174,136,-38,False
-2,270,156,154,-2,False
-2,63,138,140,2,False
-2,362,164,146,-18,False
-2,155,146,148,2,False
-2,454,172,138,-34,False
-2,247,154,156,2,False
-2,40,136,138,2,False
-2,339,162,148,-14,False
-2,132,144,146,2,False
-2,431,170,140,-30,False
-2,224,152,154,2,False
-2,17,134,136,2,False
-2,316,160,150,-10,False
-2,109,142,144,2,False
-2,408,168,142,-26,False
-2,201,150,152,2,False
-2,500,176,134,-42,False
-2,293,158,152,-6,False
-2,86,140,142,2,False
-2,385,166,144,-22,False
-2,178,148,150,2,False
-2,477,174,136,-38,False
-2,270,156,154,-2,False
-2,63,138,140,2,False
-2,362,164,146,-18,False
-2,155,146,148,2,False
-2,454,172,138,-34,False
-2,247,154,156,2,False
-2,40,136,138,2,False
-2,339,162,148,-14,False
-2,132,144,146,2,False
-2,431,170,140,-30,False
-2,224,152,154,2,False
-2,17,134,136,2,False
-2,316,160,150,-10,False
-2,109,142,144,2,False
-2,408,168,142,-26,False
-2,201,150,152,2,False
-2,500,176,134,-42,False
-2,293,158,152,-6,False
-2,86,140,142,2,False
-2,385,166,144,-22,False
-2,178,148,150,2,False
-2,477,174,136,-38,False
-2,270,156,154,-2,False
-2,63,138,140,2,False
-2,362,164,146,-18,False
-2,155,146,148,2,False
-2,454,172,138,-34,False
-2,247,154,156,2,False
-2,40,136,138,2,False
-2,339,162,148,-14,False
-2,132,144,146,2,False
-2,431,170,140,-30,False
-2,224,152,154,2,False
-2,17,134,136,2,False
-2,316,160,150,-10,False
-2,109,142,144,2,False
-2,408,168,142,-26,False
-2,201,150,152,2,False
-2,500,176,134,-42,False
-2,293,158,152,-6,False
-2,86,140,142,2,False
-2,385,166,144,-22,False
-2,178,148,150,2,False
-2,477,174,136,-38,False
-2,270,156,154,-2,False
-2,63,138,140,2,False
-2,362,164,146,-18,False
-2,155,146,148,2,False
-2,454,172,138,-34,False
-2,247,154,156,2,False
-2,40,136,138,2,False
-2,339,162,148,-14,False
-2,132,144,146,2,False
-2,431,170,140,-30,False
-2,224,152,154,2,False
-2,17,134,136,2,False
-2,316,160,150,-10,False
-2,109,142,144,2,False
-2,408,168,142,-26,False
-2,201,150,152,2,False
-2,500,176,134,-42,False
-2,293,158,152,-6,False
-2,86,140,142,2,False
-2,385,166,144,-22,False
-2,178,148,150,2,False
-2,477,174,136,-38,False
-2,270,156,154,-2,False
-2,63,138,140,2,False
-2,362,164,146,-18,False
-2,155,146,148,2,False
-2,454,172,138,-34,False
-2,247,154,156,2,False
-2,40,136,138,2,False
-2,339,162,148,-14,False
-2,132,144,146,2,False
-2,431,170,140,-30,False
-2,224,152,154,2,False
-2,17,134,136,2,False
-2,316,160,150,-10,False
-2,109,142,144,2,False
-2,408,168,142,-26,False
-2,201,150,152,2,False
-2,500,176,134,-42,False
-2,293,158,152,-6,False
-2,86,140,142,2,False
-2,385,166,144,-22,False
-2,178,148,150,2,False
-2,477,174,136,-38,False
-2,270,156,154,-2,False
-2,63,138,140,2,False
-2,362,164,146,-18,False
-2,155,146,148,2,False
-2,454,172,138,-34,False
-2,247,154,156,2,False
-2,40,136,138,2,False
-2,339,162,148,-14,False
-2,132,144,146,2,False
-2,431,170,140,-30,False
-2,224,152,154,2,False
-2,17,134,136,2,False
-2,316,160,150,-10,False
-2,109,142,144,2,False
-2,408,168,142,-26,False
-2,201,150,152,2,False
-2,500,176,134,-42,False
-2,293,158,152,-6,False
-2,86,140,142,2,False
-2,385,166,144,-22,False
-2,178,148,150,2,False
-2,477,174,136,-38,False
-2,270,156,154,-2,False
-2,63,138,140,2,False
-2,362,164,146,-18,False
-2,155,146,148,2,False
-2,454,172,138,-34,False
-2,247,154,156,2,False
-2,40,136,138,2,False
-2,339,162,148,-14,False
-2,132,144,146,2,False
-2,431,170,140,-30,False
-2,224,152,154,2,False
-2,17,134,136,2,False
-2,316,160,150,-10,False
-2,109,142,144,2,False
-2,408,168,142,-26,False
-2,201,150,152,2,False
-2,500,176,134,-42,False
-2,293,158,152,-6,False
-2,86,140,142,2,False
-2,385,166,144,-22,False
-2,178,148,150,2,False
-2,477,174,136,-38,False
-2,270,156,154,-2,False
-2,63,138,140,2,False
-2,362,164,146,-18,False
-2,155,146,148,2,False
-2,454,172,138,-34,False
-2,247,154,156,2,False
-2,40,136,138,2,False
-2,339,162,148,-14,False
-2,132,144,146,2,False
-2,431,170,140,-30,False
-2,224,152,154,2,False
-2,17,134,136,2,False
-2,316,160,150,-10,False
-2,109,142,144,2,False
-2,408,168,142,-26,False
-2,201,150,152,2,False
-2,500,176,134,-42,False
-2,293,158,152,-6,False
-2,86,140,142,2,False
-2,385,166,144,-22,False
-2,178,148,150,2,False
-2,477,174,136,-38,False
-2,270,156,154,-2,False
-2,63,138,140,2,False
-2,362,164,146,-18,False
-2,155,146,148,2,False
-2,454,172,138,-34,False
-2,247,154,156,2,False
-2,40,136,138,2,False
-2,339,162,148,-14,False
-2,132,144,146,2,False
-2,431,170,140,-30,False
-2,224,152,154,2,False
-2,17,134,136,2,False
-2,316,160,150,-10,False
-2,109,142,144,2,False
-2,408,168,142,-26,False
-2,201,150,152,2,False
-2,500,176,134,-42,False
-2,293,158,152,-6,False
-2,86,140,142,2,False
-2,385,166,144,-22,False
-2,178,148,150,2,False
-2,477,174,136,-38,False
-2,270,156,154,-2,False
-2,63,138,140,2,False
-2,362,164,146,-18,False
-2,155,146,148,2,False
-2,454,172,138,-34,False
-2,247,154,156,2,False
-2,40,136,138,2,False
-2,339,162,148,-14,False
-2,132,144,146,2,False
-2,431,170,140,-30,False
-2,224,152,154,2,False
-2,17,134,136,2,False
-2,316,160,150,-10,False
-2,109,142,144,2,False
-2,408,168,142,-26,False
-2,201,150,152,2,False
-2,500,176,134,-42,False
-2,293,158,152,-6,False
-2,86,140,142,2,False
-2,385,166,144,-22,False
-2,178,148,150,2,False
-2,477,174,136,-38,False
-2,270,156,154,-2,False
-2,63,138,140,2,False
-2,362,164,146,-18,False
-2,155,146,148,2,False
-2,454,172,138,-34,False
-2,247,154,156,2,False
-2,40,136,138,2,False
-2,339,162,148,-14,False
-2,132,144,146,2,False
-2,431,170,140,-30,False
-2,224,152,154,2,False
-2,17,134,136,2,False
-2,316,160,150,-10,False
-2,109,142,144,2,False
-2,408,168,142,-26,False
-2,201,150,152,2,False
-2,500,176,134,-42,False
-2,293,158,152,-6,False
-2,86,140,142,2,False
-2,385,166,144,-22,False
-2,178,148,150,2,False
-2,477,174,136,-38,False
-2,270,156,154,-2,False
-2,63,138,140,2,False
-2,362,164,146,-18,False
-2,155,146,148,2,False
-2,454,172,138,-34,False
-2,247,154,156,2,False
-2,40,136,138,2,False
-2,339,162,148,-14,False
-2,132,144,146,2,False
-2,431,170,140,-30,False
-2,224,152,154,2,False
-2,17,134,136,2,False
-2,316,160,150,-10,False
-2,109,142,144,2,False
-2,408,168,142,-26,False
-2,201,150,152,2,False
-2,500,176,134,-42,False
-2,293,158,152,-6,False
-2,86,140,142,2,False
-2,385,166,144,-22,False
-2,178,148,150,2,False
-2,477,174,136,-38,False
-2,270,156,154,-2,False
-2,63,138,140,2,False
-2,362,164,146,-18,False
-2,155,146,148,2,False
-2,454,172,138,-34,False
-2,247,154,156,2,False
-2,40,136,138,2,False
-2,339,162,148,-14,False
-2,132,144,146,2,False
-2,431,170,140,-30,False
-2,224,152,154,2,False
-2,17,134,136,2,False
-2,316,160,150,-10,False
-2,109,142,144,2,False
-2,408,168,142,-26,False
-2,201,150,152,2,False
-2,500,176,134,-42,False
-2,293,158,152,-6,False
-2,86,140,142,2,False
-2,385,166,144,-22,False
-2,178,148,150,2,False
-2,477,174,136,-38,False
-2,270,156,154,-2,False
-2,63,138,140,2,False
-2,362,164,146,-18,False
-2,155,146,148,2,False
-2,454,172,138,-34,False
-2,247,154,156,2,False
-2,40,136,138,2,False
-2,339,162,148,-14,False
-2,132,144,146,2,False
-2,431,170,140,-30,False
-2,224,152,154,2,False
-2,17,134,136,2,False
-2,316,160,150,-10,False
-2,109,142,144,2,False
-2,408,168,142,-26,False
-2,201,150,152,2,False
-2,500,176,134,-42,False
-2,293,158,152,-6,False
-2,86,140,142,2,False
-2,385,166,144,-22,False
-2,178,148,150,2,False
-2,477,174,136,-38,False
-2,270,156,154,-2,False
-2,63,138,140,2,False
-2,362,164,146,-18,False
-2,155,146,148,2,False
-2,454,172,138,-34,False
-2,247,154,156,2,False
-2,40,136,138,2,False
-2,339,162,148,-14,False
-2,132,144,146,2,False
-2,431,170,140,-30,False
-2,224,152,154,2,False
-2,17,134,136,2,False
-2,316,160,150,-10,False
-2,109,142,144,2,False
-2,408,168,142,-26,False
-2,201,150,152,2,False
-2,500,176,134,-42,False
-2,293,158,152,-6,False
-2,86,140,142,2,False
-2,385,166,144,-22,False
-2,178,148,150,2,False
-2,477,174,136,-38,False
-2,270,156,154,-2,False
-2,63,138,140,2,False
-2,362,164,146,-18,False
-2,155,146,148,2,False
-2,454,172,138,-34,False
-2,247,154,156,2,False
-2,40,136,138,2,False
-2,339,162,148,-14,False
-2,132,144,146,2,False
-2,431,170,140,-30,False
-2,224,152,154,2,False
-2,17,134,136,2,False
-2,316,160,150,-10,False
-2,109,142,144,2,False
-2,408,168,142,-26,False
-2,201,150,152,2,False
-2,500,176,134,-42,False
-2,293,158,152,-6,False
-2,86,140,142,2,False
-2,385,166,144,-22,False
-2,178,148,150,2,False
-2,477,174,136,-38,False
-2,270,156,154,-2,False
-2,63,138,140,2,False
-2,362,164,146,-18,False
-2,155,146,148,2,False
-2,454,172,138,-34,False
-2,247,154,156,2,False
-2,40,136,138,2,False
-2,339,162,148,-14,False
-2,132,144,146,2,False
-2,431,170,140,-30,False
-2,224,152,154,2,False
-2,17,134,136,2,False
-2,316,160,150,-10,False
-2,109,142,144,2,False
-2,408,168,142,-26,False
-2,201,150,152,2,False
-2,500,176,134,-42,False
-2,293,158,152,-6,False
-2,86,140,142,2,False
-2,385,166,144,-22,False
-2,178,148,150,2,False
-2,477,174,136,-38,False
-2,270,156,154,-2,False
-2,63,138,140,2,False
-2,362,164,146,-18,False
-2,155,146,148,2,False
-2,454,172,138,-34,False
-2,247,154,156,2,False
-2,40,136,138,2,False
-2,339,162,148,-14,False
-2,132,144,146,2,False
-2,431,170,140,-30,False
-2,224,152,154,2,False
-2,17,134,136,2,False
-2,316,160,150,-10,False
-2,109,142,144,2,False
-2,408,168,142,-26,False
-2,201,150,152,2,False
-2,500,176,134,-42,False
-2,293,158,152,-6,False
-2,86,140,142,2,False
-2,385,166,144,-22,False
-2,178,148,150,2,False
-2,477,174,136,-38,False
-2,270,156,154,-2,False
-2,63,138,140,2,False
-2,362,164,146,-18,False
-2,155,146,148,2,False
-2,454,172,138,-34,False
-2,247,154,156,2,False
-2,40,136,138,2,False
-2,339,162,148,-14,False
-2,132,144,146,2,False
-2,431,170,140,-30,False
-2,224,152,154,2,False
-2,17,134,136,2,False
-2,316,160,150,-10,False
-2,109,142,144,2,False
-2,408,168,142,-26,False
-2,201,150,152,2,False
-2,500,176,134,-42,False
-2,293,158,152,-6,False
-2,86,140,142,2,False
-2,385,166,144,-22,False
-2,178,148,150,2,False
-2,477,174,136,-38,False
-2,270,156,154,-2,False
-2,63,138,140,2,False
-2,362,164,146,-18,False
-2,155,146,148,2,False
-2,454,172,138,-34,False
-2,247,154,156,2,False
-2,40,136,138,2,False
-2,339,162,148,-14,False
-2,132,144,146,2,False
-2,431,170,140,-30,False
-2,224,152,154,2,False
-2,17,134,136,2,False
-2,316,160,150,-10,False
-2,109,142,144,2,False
-2,408,168,142,-26,False
-2,201,150,152,2,False
-2,500,176,134,-42,False
-2,293,158,152,-6,False
-2,86,140,142,2,False
-2,385,166,144,-22,False
-2,178,148,150,2,False
-2,477,174,136,-38,False
-2,270,156,154,-2,False
-2,63,138,140,2,False
-2,362,164,146,-18,False
-2,155,146,148,2,False
-2,454,172,138,-34,False
-2,247,154,156,2,False
-2,40,136,138,2,False
-2,339,162,148,-14,False
-2,132,144,146,2,False
-2,431,170,140,-30,False
-2,224,152,154,2,False
-2,17,134,136,2,False
-2,316,160,150,-10,False
-2,109,142,144,2,False
-2,408,168,142,-26,False
-2,201,150,152,2,False
-2,500,176,134,-42,False
-2,293,158,152,-6,False
-2,86,140,142,2,False
-2,385,166,144,-22,False
-2,178,148,150,2,False
-2,477,174,136,-38,False
-2,270,156,154,-2,False
-2,63,138,140,2,False
-2,362,164,146,-18,False
-2,155,146,148,2,False
-2,454,172,138,-34,False
-2,247,154,156,2,False
-2,40,136,138,2,False
-2,339,162,148,-14,False
-2,132,144,146,2,False
-2,431,170,140,-30,False
-2,224,152,154,2,False
-2,17,134,136,2,False
-2,316,160,150,-10,False
-2,109,142,144,2,False
-2,408,168,142,-26,False
-2,201,150,152,2,False
-2,500,176,134,-42,False
-2,293,158,152,-6,False
-2,86,140,142,2,False
-2,385,166,144,-22,False
-2,178,148,150,2,False
-2,477,174,136,-38,False
-2,270,156,154,-2,False
-2,63,138,140,2,False
-2,362,164,146,-18,False
-2,155,146,148,2,False
-2,454,172,138,-34,False
-2,247,154,156,2,False
-2,40,136,138,2,False
-2,339,162,148,-14,False
-2,132,144,146,2,False
-2,431,170,140,-30,False
-2,224,152,154,2,False
-2,17,134,136,2,False
-2,316,160,150,-10,False
-2,109,142,144,2,False
-2,408,168,142,-26,False
-2,201,150,152,2,False
-2,500,176,134,-42,False
-2,293,158,152,-6,False
-2,86,140,142,2,False
-2,385,166,144,-22,False
-2,178,148,150,2,False
-2,477,174,136,-38,False
-2,270,156,154,-2,False
-2,63,138,140,2,False
-2,362,164,146,-18,False
-2,155,146,148,2,False
-2,454,172,138,-34,False
-2,247,154,156,2,False
-2,40,136,138,2,False
-2,339,162,148,-14,False
-2,132,144,146,2,False
-2,431,170,140,-30,False
-2,224,152,154,2,False
-2,17,134,136,2,False
-2,316,160,150,-10,False
-2,109,142,144,2,False
-2,408,168,142,-26,False
-2,201,150,152,2,False
-2,500,176,134,-42,False
-2,293,158,152,-6,False
-2,86,140,142,2,False
-2,385,166,144,-22,False
-2,178,148,150,2,False
-2,477,174,136,-38,False
-2,270,156,154,-2,False
-2,63,138,140,2,False
-2,362,164,146,-18,False
-2,155,146,148,2,False
-2,454,172,138,-34,False
-2,247,154,156,2,False
-2,40,136,138,2,False
-2,339,162,148,-14,False
-2,132,144,146,2,False
-2,431,170,140,-30,False
-2,224,152,154,2,False
-2,17,134,136,2,False
-2,316,160,150,-10,False
-2,109,142,144,2,False
-2,408,168,142,-26,False
-2,201,150,152,2,False
-2,500,176,134,-42,False
-2,293,158,152,-6,False
-2,86,140,142,2,False
-2,385,166,144,-22,False
-2,178,148,150,2,False
-2,477,174,136,-38,False
-2,270,156,154,-2,False
-2,63,138,140,2,False
-2,362,164,146,-18,False
-2,155,146,148,2,False
-2,454,172,138,-34,False
-2,247,154,156,2,False
-2,40,136,138,2,False
-2,339,162,148,-14,False
-2,132,144,146,2,False
-2,431,170,140,-30,False
-2,224,152,154,2,False
-2,17,134,136,2,False
-2,316,160,150,-10,False
-2,109,142,144,2,False
-2,408,168,142,-26,False
-2,201,150,152,2,False
-2,500,176,134,-42,False
-2,293,158,152,-6,False
-2,86,140,142,2,False
-2,385,166,144,-22,False
-2,178,148,150,2,False
-2,477,174,136,-38,False
-2,270,156,154,-2,False
-2,63,138,140,2,False
-2,362,164,146,-18,False
-2,155,146,148,2,False
-2,454,172,138,-34,False
-2,247,154,156,2,False
-2,40,136,138,2,False
-2,339,162,148,-14,False
-2,132,144,146,2,False
-2,431,170,140,-30,False
-2,224,152,154,2,False
-2,17,134,136,2,False
-2,316,160,150,-10,False
-2,109,142,144,2,False
-2,408,168,142,-26,False
-2,201,150,152,2,False
-2,500,176,134,-42,False
-2,293,158,152,-6,False
-2,86,140,142,2,False
-2,385,166,144,-22,False
-2,178,148,150,2,False
-2,477,174,136,-38,False
-2,270,156,154,-2,False
-2,63,138,140,2,False
-2,362,164,146,-18,False
-2,155,146,148,2,False
-2,454,172,138,-34,False
-2,247,154,156,2,False
-2,40,136,138,2,False
-2,339,162,148,-14,False
-2,132,144,146,2,False
-2,431,170,140,-30,False
-2,224,152,154,2,False
-2,17,134,136,2,False
-2,316,160,150,-10,False
-2,109,142,144,2,False
-2,408,168,142,-26,False
-2,201,150,152,2,False
-2,500,176,134,-42,False
-2,293,158,152,-6,False
-2,86,140,142,2,False
-2,385,166,144,-22,False
-2,178,148,150,2,False
-2,477,174,136,-38,False
-2,270,156,154,-2,False
-2,63,138,140,2,False
-2,362,164,146,-18,False
-2,155,146,148,2,False
-2,454,172,138,-34,False
-2,247,154,156,2,False
-2,40,136,138,2,False
-2,339,162,148,-14,False
-2,132,144,146,2,False
-2,431,170,140,-30,False
-2,224,152,154,2,False
-2,17,134,136,2,False
-2,316,160,150,-10,False
-2,109,142,144,2,False
-2,408,168,142,-26,False
-2,201,150,152,2,False
-2,500,176,134,-42,False
-2,293,158,152,-6,False
-2,86,140,142,2,False
-2,385,166,144,-22,False
-2,178,148,150,2,False
-2,477,174,136,-38,False
-2,270,156,154,-2,False
-2,63,138,140,2,False
-2,362,164,146,-18,False
-2,155,146,148,2,False
-2,454,172,138,-34,False
-2,247,154,156,2,False
-2,40,136,138,2,False
-2,339,162,148,-14,False
-2,132,144,146,2,False
-2,431,170,140,-30,False
-2,224,152,154,2,False
-2,17,134,136,2,False
-2,316,160,150,-10,False
-2,109,142,144,2,False
-2,408,168,142,-26,False
-2,201,150,152,2,False
-2,500,176,134,-42,False
-2,293,158,152,-6,False
-2,86,140,142,2,False
-2,385,166,144,-22,False
-2,178,148,150,2,False
-2,477,174,136,-38,False
-2,270,156,154,-2,False
-2,63,138,140,2,False
-2,362,164,146,-18,False
-2,155,146,148,2,False
-2,454,172,138,-34,False
-2,247,154,156,2,False
-2,40,136,138,2,False
-2,339,162,148,-14,False
-2,132,144,146,2,False
-2,431,170,140,-30,False
-2,224,152,154,2,False
-2,17,134,136,2,False
-2,316,160,150,-10,False
-2,109,142,144,2,False
-2,408,168,142,-26,False
-2,201,150,152,2,False
-2,500,176,134,-42,False
-2,293,158,152,-6,False
-2,86,140,142,2,False
-2,385,166,144,-22,False
-2,178,148,150,2,False
-2,477,174,136,-38,False
-2,270,156,154,-2,False
-2,63,138,140,2,False
-2,362,164,146,-18,False
-2,155,146,148,2,False
-2,454,172,138,-34,False
-2,247,154,156,2,False
-2,40,136,138,2,False
-2,339,162,148,-14,False
-2,132,144,146,2,False
-2,431,170,140,-30,False
-2,224,152,154,2,False
-2,17,134,136,2,False
-2,316,160,150,-10,False
-2,109,142,144,2,False
-2,408,168,142,-26,False
-2,201,150,152,2,False
-2,500,176,134,-42,False
-2,293,158,152,-6,False
-2,86,140,142,2,False
-2,385,166,144,-22,False
-2,178,148,150,2,False
-2,477,174,136,-38,False
-2,270,156,154,-2,False
-2,63,138,140,2,False
-2,362,164,146,-18,False
-2,155,146,148,2,False
-2,454,172,138,-34,False
-2,247,154,156,2,False
-2,40,136,138,2,False
-2,339,162,148,-14,False
-2,132,144,146,2,False
-2,431,170,140,-30,False
-2,224,152,154,2,False
-2,17,134,136,2,False
-2,316,160,150,-10,False
-2,109,142,144,2,False
-2,408,168,142,-26,False
-2,201,150,152,2,False
-2,500,176,134,-42,False
-2,293,158,152,-6,False
-2,86,140,142,2,False
-2,385,166,144,-22,False
-2,178,148,150,2,False
-2,477,174,136,-38,False
-2,270,156,154,-2,False
-2,63,138,140,2,False
-2,362,164,146,-18,False
-2,155,146,148,2,False
-2,454,172,138,-34,False
-2,247,154,156,2,False
-2,40,136,138,2,False
-2,339,162,148,-14,False
-2,132,144,146,2,False
-2,431,170,140,-30,False
-2,224,152,154,2,False
-2,17,134,136,2,False
-2,316,160,150,-10,False
-2,109,142,144,2,False
-2,408,168,142,-26,False
-2,201,150,152,2,False
-2,500,176,134,-42,False
-2,293,158,152,-6,False
-2,86,140,142,2,False
-2,385,166,144,-22,False
-2,178,148,150,2,False
-2,477,174,136,-38,False
-2,270,156,154,-2,False
-2,63,138,140,2,False
-2,362,164,146,-18,False
-2,155,146,148,2,False
-2,454,172,138,-34,False
-2,247,154,156,2,False
-2,40,136,138,2,False
-2,339,162,148,-14,False
-2,132,144,146,2,False
-2,431,170,140,-30,False
-2,224,152,154,2,False
-2,17,134,136,2,False
-2,316,160,150,-10,False
-2,109,142,144,2,False
-2,408,168,142,-26,False
-2,201,150,152,2,False
-2,500,176,134,-42,False
-2,293,158,152,-6,False
-2,86,140,142,2,False
-2,385,166,144,-22,False
-2,178,148,150,2,False
-2,477,174,136,-38,False
-2,270,156,154,-2,False
-2,63,138,140,2,False
-2,362,164,146,-18,False
-2,155,146,148,2,False
-2,454,172,138,-34,False
-2,247,154,156,2,False
-2,40,136,138,2,False
-2,339,162,148,-14,False
-2,132,144,146,2,False
-2,431,170,140,-30,False
-2,224,152,154,2,False
-2,17,134,136,2,False
-2,316,160,150,-10,False
-2,109,142,144,2,False
-2,408,168,142,-26,False
-2,201,150,152,2,False
-2,500,176,134,-42,False
-2,293,158,152,-6,False
-2,86,140,142,2,False
-2,385,166,144,-22,False
-2,178,148,150,2,False
-2,477,174,136,-38,False
-2,270,156,154,-2,False
-2,63,138,140,2,False
-2,362,164,146,-18,False
-2,155,146,148,2,False
-2,454,172,138,-34,False
-2,247,154,156,2,False
-2,40,136,138,2,False
-2,339,162,148,-14,False
-2,132,144,146,2,False
-2,431,170,140,-30,False
-2,224,152,154,2,False
-2,17,134,136,2,False
-2,316,160,150,-10,False
-2,109,142,144,2,False
-2,408,168,142,-26,False
-2,201,150,152,2,False
-2,500,176,134,-42,False
-2,293,158,152,-6,False
-2,86,140,142,2,False
-2,385,166,144,-22,False
-2,178,148,150,2,False
-2,477,174,136,-38,False
-2,270,156,154,-2,False
-2,63,138,140,2,False
-2,362,164,146,-18,False
-2,155,146,148,2,False
-2,454,172,138,-34,False
-2,247,154,156,2,False
-2,40,136,138,2,False
-2,339,162,148,-14,False
-2,132,144,146,2,False
-2,431,170,140,-30,False
-2,224,152,154,2,False
-2,17,134,136,2,False
-2,316,160,150,-10,False
-2,109,142,144,2,False
-2,408,168,142,-26,False
-2,201,150,152,2,False
-2,500,176,134,-42,False
-2,293,158,152,-6,False
-2,86,140,142,2,False
-2,385,166,144,-22,False
-2,178,148,150,2,False
-2,477,174,136,-38,False
-2,270,156,154,-2,False
-2,63,138,140,2,False
-2,362,164,146,-18,False
-2,155,146,148,2,False
-2,454,172,138,-34,False
-2,247,154,156,2,False
-2,40,136,138,2,False
-2,339,162,148,-14,False
-2,132,144,146,2,False
-2,431,170,140,-30,False
-2,224,152,154,2,False
-2,17,134,136,2,False
-2,316,160,150,-10,False
-2,109,142,144,2,False
-2,408,168,142,-26,False
-2,201,150,152,2,False
-2,500,176,134,-42,False
-2,293,158,152,-6,False
-2,86,140,142,2,False
-2,385,166,144,-22,False
-2,178,148,150,2,False
-2,477,174,136,-38,False
-2,270,156,154,-2,False
-2,63,138,140,2,False
-2,362,164,146,-18,False
-2,155,146,148,2,False
-2,454,172,138,-34,False
-2,247,154,156,2,False
-2,40,136,138,2,False
-2,339,162,148,-14,False
-2,132,144,146,2,False
-2,431,170,140,-30,False
-2,224,152,154,2,False
-2,17,134,136,2,False
-2,316,160,150,-10,False
-2,109,142,144,2,False
-2,408,168,142,-26,False
-2,201,150,152,2,False
-2,500,176,134,-42,False
-2,293,158,152,-6,False
-2,86,140,142,2,False
-2,385,166,144,-22,False
-2,178,148,150,2,False
-2,477,174,136,-38,False
-2,270,156,154,-2,False
-2,63,138,140,2,False
-2,362,164,146,-18,False
-2,155,146,148,2,False
-2,454,172,138,-34,False
-2,247,154,156,2,False
-2,40,136,138,2,False
-2,339,162,148,-14,False
-2,132,144,146,2,False
-2,431,170,140,-30,False
-2,224,152,154,2,False
-2,17,134,136,2,False
-2,316,160,150,-10,False
-2,109,142,144,2,False
-2,408,168,142,-26,False
-2,201,150,152,2,False
-2,500,176,134,-42,False
-2,293,158,152,-6,False
-2,86,140,142,2,False
-2,385,166,144,-22,False
-2,178,148,150,2,False
-2,477,174,136,-38,False
-2,270,156,154,-2,False
-2,63,138,140,2,False
-2,362,164,146,-18,False
-2,155,146,148,2,False
-2,454,172,138,-34,False
-2,247,154,156,2,False
-2,40,136,138,2,False
-2,339,162,148,-14,False
-2,132,144,146,2,False
-2,431,170,140,-30,False
-2,224,152,154,2,False
-2,17,134,136,2,False
-2,316,160,150,-10,False
-2,109,142,144,2,False
-2,408,168,142,-26,False
-2,201,150,152,2,False
-2,500,176,134,-42,False
-2,293,158,152,-6,False
-2,86,140,142,2,False
-2,385,166,144,-22,False
-2,178,148,150,2,False
-2,477,174,136,-38,False
-2,270,156,154,-2,False
-2,63,138,140,2,False
-2,362,164,146,-18,False
-2,155,146,148,2,False
-2,454,172,138,-34,False
-2,247,154,156,2,False
-2,40,136,138,2,False
-2,339,162,148,-14,False
-2,132,144,146,2,False
-2,431,170,140,-30,False
-2,224,152,154,2,False
-2,17,134,136,2,False
-2,316,160,150,-10,False
-2,109,142,144,2,False
-2,408,168,142,-26,False
-2,201,150,152,2,False
-2,500,176,134,-42,False
-2,293,158,152,-6,False
-2,86,140,142,2,False
-2,385,166,144,-22,False
-2,178,148,150,2,False
-2,477,174,136,-38,False
-2,270,156,154,-2,False
-2,63,138,140,2,False
-2,362,164,146,-18,False
-2,155,146,148,2,False
-2,454,172,138,-34,False
-2,247,154,156,2,False
-2,40,136,138,2,False
-2,339,162,148,-14,False
-2,132,144,146,2,False
-2,431,170,140,-30,False
-2,224,152,154,2,False
-2,17,134,136,2,False
-2,316,160,150,-10,False
-2,109,142,144,2,False
-2,408,168,142,-26,False
-2,201,150,152,2,False
-2,500,176,134,-42,False
-2,293,158,152,-6,False
-2,86,140,142,2,False
-2,385,166,144,-22,False
-2,178,148,150,2,False
-2,477,174,136,-38,False
-2,270,156,154,-2,False
-2,63,138,140,2,False
-2,362,164,146,-18,False
-2,155,146,148,2,False
-2,454,172,138,-34,False
-2,247,154,156,2,False
-2,40,136,138,2,False
-2,339,162,148,-14,False
-2,132,144,146,2,False
-2,431,170,140,-30,False
-2,224,152,154,2,False
-2,17,134,136,2,False
-2,316,160,150,-10,False
-2,109,142,144,2,False
-2,408,168,142,-26,False
-2,201,150,152,2,False
-2,500,176,134,-42,False
-2,293,158,152,-6,False
-2,86,140,142,2,False
-2,385,166,144,-22,False
-2,178,148,150,2,False
-2,477,174,136,-38,False
-2,270,156,154,-2,False
-2,63,138,140,2,False
-2,362,164,146,-18,False
-2,155,146,148,2,False
-2,454,172,138,-34,False
-2,247,154,156,2,False
-2,40,136,138,2,False
-2,339,162,148,-14,False
-2,132,144,146,2,False
-2,431,170,140,-30,False
-2,224,152,154,2,False
-2,17,134,136,2,False
-2,316,160,150,-10,False
-2,109,142,144,2,False
-2,408,168,142,-26,False
-2,201,150,152,2,False
-2,500,176,134,-42,False
-2,293,158,152,-6,False
-2,86,140,142,2,False
-2,385,166,144,-22,False
-2,178,148,150,2,False
-2,477,174,136,-38,False
-2,270,156,154,-2,False
-2,63,138,140,2,False
-2,362,164,146,-18,False
-2,155,146,148,2,False
-2,454,172,138,-34,False
-2,247,154,156,2,False
-2,40,136,138,2,False
-2,339,162,148,-14,False
-2,132,144,146,2,False
-2,431,170,140,-30,False
-2,224,152,154,2,False
-2,17,134,136,2,False
-2,316,160,150,-10,False
-2,109,142,144,2,False
-2,408,168,142,-26,False
-2,201,150,152,2,False
-2,500,176,134,-42,False
-2,293,158,152,-6,False
-2,86,140,142,2,False
-2,385,166,144,-22,False
-2,178,148,150,2,False
-2,477,174,136,-38,False
-2,270,156,154,-2,False
-2,63,138,140,2,False
-2,362,164,146,-18,False
-2,155,146,148,2,False
-2,454,172,138,-34,False
-2,247,154,156,2,False
-2,40,136,138,2,False
-2,339,162,148,-14,False
-2,132,144,146,2,False
-2,431,170,140,-30,False
-2,224,152,154,2,False
-2,17,134,136,2,False
-2,316,160,150,-10,False
-2,109,142,144,2,False
-2,408,168,142,-26,False
-2,201,150,152,2,False
-2,500,176,134,-42,False
-2,293,158,152,-6,False
-2,86,140,142,2,False
-2,385,166,144,-22,False
-2,178,148,150,2,False
-2,477,174,136,-38,False
-2,270,156,154,-2,False
-2,63,138,140,2,False
-2,362,164,146,-18,False
-2,155,146,148,2,False
-2,454,172,138,-34,False
-2,247,154,156,2,False
-2,40,136,138,2,False
-2,339,162,148,-14,False
-2,132,144,146,2,False
-2,431,170,140,-30,False
-2,224,152,154,2,False
-2,17,134,136,2,False
-2,316,160,150,-10,False
-2,109,142,144,2,False
-2,408,168,142,-26,False
-2,201,150,152,2,False
-2,500,176,134,-42,False
-2,293,158,152,-6,False
-2,86,140,142,2,False
-2,385,166,144,-22,False
-2,178,148,150,2,False
-2,477,174,136,-38,False
-2,270,156,154,-2,False
-2,63,138,140,2,False
-2,362,164,146,-18,False
-2,155,146,148,2,False
-2,454,172,138,-34,False
-2,247,154,156,2,False
-2,40,136,138,2,False
-2,339,162,148,-14,False
-2,132,144,146,2,False
-2,431,170,140,-30,False
-2,224,152,154,2,False
-2,17,134,136,2,False
-2,316,160,150,-10,False
-2,109,142,144,2,False
-2,408,168,142,-26,False
-2,201,150,152,2,False
-2,500,176,134,-42,False
-2,293,158,152,-6,False
-2,86,140,142,2,False
-2,385,166,144,-22,False
-2,178,148,150,2,False
-2,477,174,136,-38,False
-2,270,156,154,-2,False
-2,63,138,140,2,False
-2,362,164,146,-18,False
-2,155,146,148,2,False
-2,454,172,138,-34,False
-2,247,154,156,2,False
-2,40,136,138,2,False
-2,339,162,148,-14,False
-2,132,144,146,2,False
-2,431,170,140,-30,False
-2,224,152,154,2,False
-2,17,134,136,2,False
-2,316,160,150,-10,False
-2,109,142,144,2,False
-2,408,168,142,-26,False
-2,201,150,152,2,False
-2,500,176,134,-42,False
-2,293,158,152,-6,False
-2,86,140,142,2,False
-2,385,166,144,-22,False
-2,178,148,150,2,False
-2,477,174,136,-38,False
-2,270,156,154,-2,False
-2,63,138,140,2,False
-2,362,164,146,-18,False
-2,155,146,148,2,False
-2,454,172,138,-34,False
-2,247,154,156,2,False
-2,40,136,138,2,False
-2,339,162,148,-14,False
-2,132,144,146,2,False
-2,431,170,140,-30,False
-2,224,152,154,2,False
-2,17,134,136,2,False
-2,316,160,150,-10,False
-2,109,142,144,2,False
-2,408,168,142,-26,False
-2,201,150,152,2,False
-2,500,176,134,-42,False
-2,293,158,152,-6,False
-2,86,140,142,2,False
-2,385,166,144,-22,False
-2,178,148,150,2,False
-2,477,174,136,-38,False
-2,270,156,154,-2,False
-2,63,138,140,2,False
-2,362,164,146,-18,False
-2,155,146,148,2,False
-2,454,172,138,-34,False
-2,247,154,156,2,False
-2,40,136,138,2,False
-2,339,162,148,-14,False
-2,132,144,146,2,False
-2,431,170,140,-30,False
-2,224,152,154,2,False
-2,17,134,136,2,False
-2,316,160,150,-10,False
-2,109,142,144,2,False
-2,408,168,142,-26,False
-2,201,150,152,2,False
-2,500,176,134,-42,False
-2,293,158,152,-6,False
-2,86,140,142,2,False
-2,385,166,144,-22,False
-2,178,148,150,2,False
-2,477,174,136,-38,False
-2,270,156,154,-2,False
-2,63,138,140,2,False
-2,362,164,146,-18,False
-2,155,146,148,2,False
-2,454,172,138,-34,False
-2,247,154,156,2,False
-2,40,136,138,2,False
-2,339,162,148,-14,False
-2,132,144,146,2,False
-2,431,170,140,-30,False
-2,224,152,154,2,False
-2,17,134,136,2,False
-2,316,160,150,-10,False
-2,109,142,144,2,False
-2,408,168,142,-26,False
-2,201,150,152,2,False
-2,500,176,134,-42,False
-2,293,158,152,-6,False
-2,86,140,142,2,False
-2,385,166,144,-22,False
-2,178,148,150,2,False
-2,477,174,136,-38,False
-2,270,156,154,-2,False
-2,63,138,140,2,False
-2,362,164,146,-18,False
-2,155,146,148,2,False
-2,454,172,138,-34,False
-2,247,154,156,2,False
-2,40,136,138,2,False
-2,339,162,148,-14,False
-2,132,144,146,2,False
-2,431,170,140,-30,False
-2,224,152,154,2,False
-2,17,134,136,2,False
-2,316,160,150,-10,False
-2,109,142,144,2,False
-2,408,168,142,-26,False
-2,201,150,152,2,False
-2,500,176,134,-42,False
-2,293,158,152,-6,False
-2,86,140,142,2,False
-2,385,166,144,-22,False
-2,178,148,150,2,False
-2,477,174,136,-38,False
-2,270,156,154,-2,False
-2,63,138,140,2,False
-2,362,164,146,-18,False
-2,155,146,148,2,False
-2,454,172,138,-34,False
-2,247,154,156,2,False
-2,40,136,138,2,False
-2,339,162,148,-14,False
-2,132,144,146,2,False
-2,431,170,140,-30,False
-2,224,152,154,2,False
-2,17,134,136,2,False
-2,316,160,150,-10,False
-2,109,142,144,2,False
-2,408,168,142,-26,False
-2,201,150,152,2,False
-2,500,176,134,-42,False
-2,293,158,152,-6,False
-2,86,140,142,2,False
-2,385,166,144,-22,False
-2,178,148,150,2,False
-2,477,174,136,-38,False
-2,270,156,154,-2,False
-2,63,138,140,2,False
-2,362,164,146,-18,False
-2,155,146,148,2,False
-2,454,172,138,-34,False
-2,247,154,156,2,False
-2,40,136,138,2,False
-2,339,162,148,-14,False
-2,132,144,146,2,False
-2,431,170,140,-30,False
-2,224,152,154,2,False
-2,17,134,136,2,False
-2,316,160,150,-10,False
-2,109,142,144,2,False
-2,408,168,142,-26,False
-2,201,150,152,2,False
-2,500,176,134,-42,False
-2,293,158,152,-6,False
-2,86,140,142,2,False
-2,385,166,144,-22,False
-2,178,148,150,2,False
-2,477,174,136,-38,False
-2,270,156,154,-2,False
-2,63,138,140,2,False
-2,362,164,146,-18,False
-2,155,146,148,2,False
-2,454,172,138,-34,False
-2,247,154,156,2,False
-2,40,136,138,2,False
-2,339,162,148,-14,False
-2,132,144,146,2,False
-2,431,170,140,-30,False
-2,224,152,154,2,False
-2,17,134,136,2,False
-2,316,160,150,-10,False
-2,109,142,144,2,False
-2,408,168,142,-26,False
-2,201,150,152,2,False
-2,500,176,134,-42,False
-2,293,158,152,-6,False
-2,86,140,142,2,False
-2,385,166,144,-22,False
-2,178,148,150,2,False
-2,477,174,136,-38,False
-2,270,156,154,-2,False
-2,63,138,140,2,False
-2,362,164,146,-18,False
-2,155,146,148,2,False
-2,454,172,138,-34,False
-2,247,154,156,2,False
-2,40,136,138,2,False
-2,339,162,148,-14,False
-2,132,144,146,2,False
-2,431,170,140,-30,False
-2,224,152,154,2,False
-2,17,134,136,2,False
-2,316,160,150,-10,False
-2,109,142,144,2,False
-2,408,168,142,-26,False
-2,201,150,152,2,False
-2,500,176,134,-42,False
-2,293,158,152,-6,False
-2,86,140,142,2,False
-2,385,166,144,-22,False
-2,178,148,150,2,False
-2,477,174,136,-38,False
-2,270,156,154,-2,False
-2,63,138,140,2,False
-2,362,164,146,-18,False
-2,155,146,148,2,False
-2,454,172,138,-34,False
-2,247,154,156,2,False
-2,40,136,138,2,False
-2,339,162,148,-14,False
-2,132,144,146,2,False
-2,431,170,140,-30,False
-2,224,152,154,2,False
-2,17,134,136,2,False
-2,316,160,150,-10,False
-2,109,142,144,2,False
-2,408,168,142,-26,False
-2,201,150,152,2,False
-2,500,176,134,-42,False
-2,293,158,152,-6,False
-2,86,140,142,2,False
-2,385,166,144,-22,False
-2,178,148,150,2,False
-2,477,174,136,-38,False
-2,270,156,154,-2,False
-2,63,138,140,2,False
-2,362,164,146,-18,False
-2,155,146,148,2,False
-2,454,172,138,-34,False
-2,247,154,156,2,False
-2,40,136,138,2,False
-2,339,162,148,-14,False
-2,132,144,146,2,False
-2,431,170,140,-30,False
-2,224,152,154,2,False
-2,17,134,136,2,False
-2,316,160,150,-10,False
-2,109,142,144,2,False
-2,408,168,142,-26,False
-2,201,150,152,2,False
-2,500,176,134,-42,False
-2,293,158,152,-6,False
-2,86,140,142,2,False
-2,385,166,144,-22,False
-2,178,148,150,2,False
-2,477,174,136,-38,False
-2,270,156,154,-2,False
-2,63,138,140,2,False
-2,362,164,146,-18,False
-2,155,146,148,2,False
-2,454,172,138,-34,False
-2,247,154,156,2,False
-2,40,136,138,2,False
-2,339,162,148,-14,False
-2,132,144,146,2,False
-2,431,170,140,-30,False
-2,224,152,154,2,False
-2,17,134,136,2,False
-2,316,160,150,-10,False
-2,109,142,144,2,False
-2,408,168,142,-26,False
-2,201,150,152,2,False
-2,500,176,134,-42,False
-2,293,158,152,-6,False
-2,86,140,142,2,False
-2,385,166,144,-22,False
-2,178,148,150,2,False
-2,477,174,136,-38,False
-2,270,156,154,-2,False
-2,63,138,140,2,False
-2,362,164,146,-18,False
-2,155,146,148,2,False
-2,454,172,138,-34,False
-2,247,154,156,2,False
-2,40,136,138,2,False
-2,339,162,148,-14,False
-2,132,144,146,2,False
-2,431,170,140,-30,False
-2,224,152,154,2,False
-2,17,134,136,2,False
-2,316,160,150,-10,False
-2,109,142,144,2,False
-2,408,168,142,-26,False
-2,201,150,152,2,False
-2,500,176,134,-42,False
-2,293,158,152,-6,False
-2,86,140,142,2,False
-2,385,166,144,-22,False
-2,178,148,150,2,False
-2,477,174,136,-38,False
-2,270,156,154,-2,False
-2,63,138,140,2,False
-2,362,164,146,-18,False
-2,155,146,148,2,False
-2,454,172,138,-34,False
-2,247,154,156,2,False
-2,40,136,138,2,False
-2,339,162,148,-14,False
-2,132,144,146,2,False
-2,431,170,140,-30,False
-2,224,152,154,2,False
-2,17,134,136,2,False
-2,316,160,150,-10,False
-2,109,142,144,2,False
-2,408,168,142,-26,False
-2,201,150,152,2,False
-2,500,176,134,-42,False
-2,293,158,152,-6,False
-2,86,140,142,2,False
-2,385,166,144,-22,False
-2,178,148,150,2,False
-2,477,174,136,-38,False
-2,270,156,154,-2,False
-2,63,138,140,2,False
-2,362,164,146,-18,False
-2,155,146,148,2,False
-2,454,172,138,-34,False
-2,247,154,156,2,False
-2,40,136,138,2,False
-2,339,162,148,-14,False
-2,132,144,146,2,False
-2,431,170,140,-30,False
-2,224,152,154,2,False
-2,17,134,136,2,False
-2,316,160,150,-10,False
-2,109,142,144,2,False
-2,408,168,142,-26,False
-2,201,150,152,2,False
-2,500,176,134,-42,False
-2,293,158,152,-6,False
-2,86,140,142,2,False
-2,385,166,144,-22,False
-2,178,148,150,2,False
-2,477,174,136,-38,False
-2,270,156,154,-2,False
-2,63,138,140,2,False
-2,362,164,146,-18,False
-2,155,146,148,2,False
-2,454,172,138,-34,False
-2,247,154,156,2,False
-2,40,136,138,2,False
-2,339,162,148,-14,False
-2,132,144,146,2,False
-2,431,170,140,-30,False
-2,224,152,154,2,False
-2,17,134,136,2,False
-2,316,160,150,-10,False
-2,109,142,144,2,False
-2,408,168,142,-26,False
-2,201,150,152,2,False
-2,500,176,134,-42,False
-2,293,158,152,-6,False
-2,86,140,142,2,False
-2,385,166,144,-22,False
-2,178,148,150,2,False
-2,477,174,136,-38,False
-2,270,156,154,-2,False
-2,63,138,140,2,False
-2,362,164,146,-18,False
-2,155,146,148,2,False
-2,454,172,138,-34,False
-2,247,154,156,2,False
-2,40,136,138,2,False
-2,339,162,148,-14,False
-2,132,144,146,2,False
-2,431,170,140,-30,False
-2,224,152,154,2,False
-2,17,134,136,2,False
-2,316,160,150,-10,False
-2,109,142,144,2,False
-2,408,168,142,-26,False
-2,201,150,152,2,False
-2,500,176,134,-42,False
-2,293,158,152,-6,False
-2,86,140,142,2,False
-2,385,166,144,-22,False
-2,178,148,150,2,False
-2,477,174,136,-38,False
-2,270,156,154,-2,False
-2,63,138,140,2,False
-2,362,164,146,-18,False
-2,155,146,148,2,False
-2,454,172,138,-34,False
-2,247,154,156,2,False
-2,40,136,138,2,False
-2,339,162,148,-14,False
-2,132,144,146,2,False
-2,431,170,140,-30,False
-2,224,152,154,2,False
-2,17,134,136,2,False
-2,316,160,150,-10,False
-2,109,142,144,2,False
-2,408,168,142,-26,False
-2,201,150,152,2,False
-2,500,176,134,-42,False
-2,293,158,152,-6,False
-2,86,140,142,2,False
-2,385,166,144,-22,False
-2,178,148,150,2,False
-2,477,174,136,-38,False
-2,270,156,154,-2,False
-2,63,138,140,2,False
-2,362,164,146,-18,False
-2,155,146,148,2,False
-2,454,172,138,-34,False
-2,247,154,156,2,False
-2,40,136,138,2,False
-2,339,162,148,-14,False
-2,132,144,146,2,False
-2,431,170,140,-30,False
-2,224,152,154,2,False
-2,17,134,136,2,False
-2,316,160,150,-10,False
-2,109,142,144,2,False
-2,408,168,142,-26,False
-2,201,150,152,2,False
-2,500,176,134,-42,False
-2,293,158,152,-6,False
-2,86,140,142,2,False
-2,385,166,144,-22,False
-2,178,148,150,2,False
-2,477,174,136,-38,False
-2,270,156,154,-2,False
-2,63,138,140,2,False
-2,362,164,146,-18,False
-2,155,146,148,2,False
-2,454,172,138,-34,False
-2,247,154,156,2,False
-2,40,136,138,2,False
-2,339,162,148,-14,False
-2,132,144,146,2,False
-2,431,170,140,-30,False
-2,224,152,154,2,False
-2,17,134,136,2,False
-2,316,160,150,-10,False
-2,109,142,144,2,False
-2,408,168,142,-26,False
-2,201,150,152,2,False
-2,500,176,134,-42,False
-2,293,158,152,-6,False
-2,86,140,142,2,False
-2,385,166,144,-22,False
-2,178,148,150,2,False
-2,477,174,136,-38,False
-2,270,156,154,-2,False
-2,63,138,140,2,False
-2,362,164,146,-18,False
-2,155,146,148,2,False
-2,454,172,138,-34,False
-2,247,154,156,2,False
-2,40,136,138,2,False
-2,339,162,148,-14,False
-2,132,144,146,2,False
-2,431,170,140,-30,False
-2,224,152,154,2,False
-2,17,134,136,2,False
-2,316,160,150,-10,False
-2,109,142,144,2,False
-2,408,168,142,-26,False
-2,201,150,152,2,False
-2,500,176,134,-42,False
-2,293,158,152,-6,False
-2,86,140,142,2,False
-2,385,166,144,-22,False
-2,178,148,150,2,False
-2,477,174,136,-38,False
-2,270,156,154,-2,False
-2,63,138,140,2,False
-2,362,164,146,-18,False
-2,155,146,148,2,False
-2,454,172,138,-34,False
-2,247,154,156,2,False
-2,40,136,138,2,False
-2,339,162,148,-14,False
-2,132,144,146,2,False
-2,431,170,140,-30,False
-2,224,152,154,2,False
-2,17,134,136,2,False
-2,316,160,150,-10,False
-2,109,142,144,2,False
-2,408,168,142,-26,False
-2,201,150,152,2,False
-2,500,176,134,-42,False
-2,293,158,152,-6,False
-2,86,140,142,2,False
-2,385,166,144,-22,False
-2,178,148,150,2,False
-2,477,174,136,-38,False
-2,270,156,154,-2,False
-2,63,138,140,2,False
-2,362,164,146,-18,False
-2,155,146,148,2,False
-2,454,172,138,-34,False
-2,247,154,156,2,False
-2,40,136,138,2,False
-2,339,162,148,-14,False
-2,132,144,146,2,False
-2,431,170,140,-30,False
-2,224,152,154,2,False
-2,17,134,136,2,False
-2,316,160,150,-10,False
-2,109,142,144,2,False
-2,408,168,142,-26,False
-2,201,150,152,2,False
-2,500,176,134,-42,False
-2,293,158,152,-6,False
-2,86,140,142,2,False
-2,385,166,144,-22,False
-2,178,148,150,2,False
-2,477,174,136,-38,False
-2,270,156,154,-2,False
-2,63,138,140,2,False
-2,362,164,146,-18,False
-2,155,146,148,2,False
-2,454,172,138,-34,False
-2,247,154,156,2,False
-2,40,136,138,2,False
-2,339,162,148,-14,False
-2,132,144,146,2,False
-2,431,170,140,-30,False
-2,224,152,154,2,False
-2,17,134,136,2,False
-2,316,160,150,-10,False
-2,109,142,144,2,False
-2,408,168,142,-26,False
-2,201,150,152,2,False
-2,500,176,134,-42,False
-2,293,158,152,-6,False
-2,86,140,142,2,False
-2,385,166,144,-22,False
-2,178,148,150,2,False
-2,477,174,136,-38,False
-2,270,156,154,-2,False
-2,63,138,140,2,False
-2,362,164,146,-18,False
-2,155,146,148,2,False
-2,454,172,138,-34,False
-2,247,154,156,2,False
-2,40,136,138,2,False
-2,339,162,148,-14,False
-2,132,144,146,2,False
-2,431,170,140,-30,False
-2,224,152,154,2,False
-2,17,134,136,2,False
-2,316,160,150,-10,False
-2,109,142,144,2,False
-2,408,168,142,-26,False
-2,201,150,152,2,False
-2,500,176,134,-42,False
-2,293,158,152,-6,False
-2,86,140,142,2,False
-2,385,166,144,-22,False
-2,178,148,150,2,False
-2,477,174,136,-38,False
-2,270,156,154,-2,False
-2,63,138,140,2,False
-2,362,164,146,-18,False
-2,155,146,148,2,False
-2,454,172,138,-34,False
-2,247,154,156,2,False
-2,40,136,138,2,False
-2,339,162,148,-14,False
-2,132,144,146,2,False
-2,431,170,140,-30,False
-2,224,152,154,2,False
-2,17,134,136,2,False
-2,316,160,150,-10,False
-2,109,142,144,2,False
-2,408,168,142,-26,False
-2,201,150,152,2,False
-2,500,176,134,-42,False
-2,293,158,152,-6,False
-2,86,140,142,2,False
-2,385,166,144,-22,False
-2,178,148,150,2,False
-2,477,174,136,-38,False
-2,270,156,154,-2,False
-2,63,138,140,2,False
-2,362,164,146,-18,False
-2,155,146,148,2,False
-2,454,172,138,-34,False
-2,247,154,156,2,False
-2,40,136,138,2,False
-2,339,162,148,-14,False
-2,132,144,146,2,False
-2,431,170,140,-30,False
-2,224,152,154,2,False
-2,17,134,136,2,False
-2,316,160,150,-10,False
-2,109,142,144,2,False
-2,408,168,142,-26,False
-2,201,150,152,2,False
-2,500,176,134,-42,False
-2,293,158,152,-6,False
-2,86,140,142,2,False
-2,385,166,144,-22,False
-2,178,148,150,2,False
-2,477,174,136,-38,False
-2,270,156,154,-2,False
-2,63,138,140,2,False
-2,362,164,146,-18,False
-2,155,146,148,2,False
-2,454,172,138,-34,False
-2,247,154,156,2,False
-2,40,136,138,2,False
-2,339,162,148,-14,False
-2,132,144,146,2,False
-2,431,170,140,-30,False
-2,224,152,154,2,False
-2,17,134,136,2,False
-2,316,160,150,-10,False
-2,109,142,144,2,False
-2,408,168,142,-26,False
-2,201,150,152,2,False
-2,500,176,134,-42,False
-2,293,158,152,-6,False
-2,86,140,142,2,False
-2,385,166,144,-22,False
-2,178,148,150,2,False
-2,477,174,136,-38,False
-2,270,156,154,-2,False
-2,63,138,140,2,False
-2,362,164,146,-18,False
-2,155,146,148,2,False
-2,454,172,138,-34,False
-2,247,154,156,2,False
-2,40,136,138,2,False
-2,339,162,148,-14,False
-2,132,144,146,2,False
-2,431,170,140,-30,False
-2,224,152,154,2,False
-2,17,134,136,2,False
-2,316,160,150,-10,False
-2,109,142,144,2,False
-2,408,168,142,-26,False
-2,201,150,152,2,False
-2,500,176,134,-42,False
-2,293,158,152,-6,False
-2,86,140,142,2,False
-2,385,166,144,-22,False
-2,178,148,150,2,False
-2,477,174,136,-38,False
-2,270,156,154,-2,False
-2,63,138,140,2,False
-2,362,164,146,-18,False
-2,155,146,148,2,False
-2,454,172,138,-34,False
-2,247,154,156,2,False
-2,40,136,138,2,False
-2,339,162,148,-14,False
-2,132,144,146,2,False
-2,431,170,140,-30,False
-2,224,152,154,2,False
-2,17,134,136,2,False
-2,316,160,150,-10,False
-2,109,142,144,2,False
-2,408,168,142,-26,False
-2,201,150,152,2,False
-2,500,176,134,-42,False
-2,293,158,152,-6,False
-2,86,140,142,2,False
-2,385,166,144,-22,False
-2,178,148,150,2,False
-2,477,174,136,-38,False
-2,270,156,154,-2,False
-2,63,138,140,2,False
-2,362,164,146,-18,False
-2,155,146,148,2,False
-2,454,172,138,-34,False
-2,247,154,156,2,False
-2,40,136,138,2,False
-2,339,162,148,-14,False
-2,132,144,146,2,False
-2,431,170,140,-30,False
-2,224,152,154,2,False
-2,17,134,136,2,False
-2,316,160,150,-10,False
-2,109,142,144,2,False
-2,408,168,142,-26,False
-2,201,150,152,2,False
-2,500,176,134,-42,False
-2,293,158,152,-6,False
-2,86,140,142,2,False
-2,385,166,144,-22,False
-2,178,148,150,2,False
-2,477,174,136,-38,False
-2,270,156,154,-2,False
-2,63,138,140,2,False
-2,362,164,146,-18,False
-2,155,146,148,2,False
-2,454,172,138,-34,False
-2,247,154,156,2,False
-2,40,136,138,2,False
-2,339,162,148,-14,False
-2,132,144,146,2,False
-2,431,170,140,-30,False
-2,224,152,154,2,False
-2,17,134,136,2,False
-2,316,160,150,-10,False
-2,109,142,144,2,False
-2,408,168,142,-26,False
-2,201,150,152,2,False
-2,500,176,134,-42,False
-2,293,158,152,-6,False
-2,86,140,142,2,False
-2,385,166,144,-22,False
-2,178,148,150,2,False
-2,477,174,136,-38,False
-2,270,156,154,-2,False
-2,63,138,140,2,False
-2,362,164,146,-18,False
-2,155,146,148,2,False
-2,454,172,138,-34,False
-2,247,154,156,2,False
-2,40,136,138,2,False
-2,339,162,148,-14,False
-2,132,144,146,2,False
-2,431,170,140,-30,False
-2,224,152,154,2,False
-2,17,134,136,2,False
-2,316,160,150,-10,False
-2,109,142,144,2,False
-2,408,168,142,-26,False
-2,201,150,152,2,False
-2,500,176,134,-42,False
-2,293,158,152,-6,False
-2,86,140,142,2,False
-2,385,166,144,-22,False
-2,178,148,150,2,False
-2,477,174,136,-38,False
-2,270,156,154,-2,False
-2,63,138,140,2,False
-2,362,164,146,-18,False
-2,155,146,148,2,False
-2,454,172,138,-34,False
-2,247,154,156,2,False
-2,40,136,138,2,False
-2,339,162,148,-14,False
-2,132,144,146,2,False
-2,431,170,140,-30,False
-2,224,152,154,2,False
-2,17,134,136,2,False
-2,316,160,150,-10,False
-2,109,142,144,2,False
-2,408,168,142,-26,False
-2,201,150,152,2,False
-2,500,176,134,-42,False
-2,293,158,152,-6,False
-2,86,140,142,2,False
-2,385,166,144,-22,False
-2,178,148,150,2,False
-2,477,174,136,-38,False
-2,270,156,154,-2,False
-2,63,138,140,2,False
-2,362,164,146,-18,False
-2,155,146,148,2,False
-2,454,172,138,-34,False
-2,247,154,156,2,False
-2,40,136,138,2,False
-2,339,162,148,-14,False
-2,132,144,146,2,False
-2,431,170,140,-30,False
-2,224,152,154,2,False
-2,17,134,136,2,False
-2,316,160,150,-10,False
-2,109,142,144,2,False
-2,408,168,142,-26,False
-2,201,150,152,2,False
-2,500,176,134,-42,False
-2,293,158,152,-6,False
-2,86,140,142,2,False
-2,385,166,144,-22,False
-2,178,148,150,2,False
-2,477,174,136,-38,False
-2,270,156,154,-2,False
-2,63,138,140,2,False
-2,362,164,146,-18,False
-2,155,146,148,2,False
-2,454,172,138,-34,False
-2,247,154,156,2,False
-2,40,136,138,2,False
-2,339,162,148,-14,False
-2,132,144,146,2,False
-2,431,170,140,-30,False
-2,224,152,154,2,False
-2,17,134,136,2,False
-2,316,160,150,-10,False
-2,109,142,144,2,False
-2,408,168,142,-26,False
-2,201,150,152,2,False
-2,500,176,134,-42,False
-2,293,158,152,-6,False
-2,86,140,142,2,False
-2,385,166,144,-22,False
-2,178,148,150,2,False
-2,477,174,136,-38,False
-2,270,156,154,-2,False
-2,63,138,140,2,False
-2,362,164,146,-18,False
-2,155,146,148,2,False
-2,454,172,138,-34,False
-2,247,154,156,2,False
-2,40,136,138,2,False
-2,339,162,148,-14,False
-2,132,144,146,2,False
-2,431,170,140,-30,False
-2,224,152,154,2,False
-2,17,134,136,2,False
-2,316,160,150,-10,False
-2,109,142,144,2,False
-2,408,168,142,-26,False
-2,201,150,152,2,False
-2,500,176,134,-42,False
-2,293,158,152,-6,False
-2,86,140,142,2,False
-2,385,166,144,-22,False
-2,178,148,150,2,False
-2,477,174,136,-38,False
-2,270,156,154,-2,False
-2,63,138,140,2,False
-2,362,164,146,-18,False
-2,155,146,148,2,False
-2,454,172,138,-34,False
-2,247,154,156,2,False
-2,40,136,138,2,False
-2,339,162,148,-14,False
-2,132,144,146,2,False
-2,431,170,140,-30,False
-2,224,152,154,2,False
-2,17,134,136,2,False
-2,316,160,150,-10,False
-2,109,142,144,2,False
-2,408,168,142,-26,False
-2,201,150,152,2,False
-2,500,176,134,-42,False
-2,293,158,152,-6,False
-2,86,140,142,2,False
-2,385,166,144,-22,False
-2,178,148,150,2,False
-2,477,174,136,-38,False
-2,270,156,154,-2,False
-2,63,138,140,2,False
-2,362,164,146,-18,False
-2,155,146,148,2,False
-2,454,172,138,-34,False
-2,247,154,156,2,False
-2,40,136,138,2,False
-2,339,162,148,-14,False
-2,132,144,146,2,False
-2,431,170,140,-30,False
-2,224,152,154,2,False
-2,17,134,136,2,False
-2,316,160,150,-10,False
-2,109,142,144,2,False
-2,408,168,142,-26,False
-2,201,150,152,2,False
-2,500,176,134,-42,False
-2,293,158,152,-6,False
-2,86,140,142,2,False
-2,385,166,144,-22,False
-2,178,148,150,2,False
-2,477,174,136,-38,False
-2,270,156,154,-2,False
-2,63,138,140,2,False
-2,362,164,146,-18,False
-2,155,146,148,2,False
-2,454,172,138,-34,False
-2,247,154,156,2,False
-2,40,136,138,2,False
-2,339,162,148,-14,False
-2,132,144,146,2,False
-2,431,170,140,-30,False
-2,224,152,154,2,False
-2,17,134,136,2,False
-2,316,160,150,-10,False
-2,109,142,144,2,False
-2,408,168,142,-26,False
-2,201,150,152,2,False
-2,500,176,134,-42,False
-2,293,158,152,-6,False
-2,86,140,142,2,False
-2,385,166,144,-22,False
-2,178,148,150,2,False
-2,477,174,136,-38,False
-2,270,156,154,-2,False
-2,63,138,140,2,False
-2,362,164,146,-18,False
-2,155,146,148,2,False
-2,454,172,138,-34,False
-2,247,154,156,2,False
-2,40,136,138,2,False
-2,339,162,148,-14,False
-2,132,144,146,2,False
-2,431,170,140,-30,False
-2,224,152,154,2,False
-2,17,134,136,2,False
-2,316,160,150,-10,False
-2,109,142,144,2,False
-2,408,168,142,-26,False
-2,201,150,152,2,False
-2,500,176,134,-42,False
-2,293,158,152,-6,False
-2,86,140,142,2,False
-2,385,166,144,-22,False
-2,178,148,150,2,False
-2,477,174,136,-38,False
-2,270,156,154,-2,False
-2,63,138,140,2,False
-2,362,164,146,-18,False
-2,155,146,148,2,False
-2,454,172,138,-34,False
-2,247,154,156,2,False
-2,40,136,138,2,False
-2,339,162,148,-14,False
-2,132,144,146,2,False
-2,431,170,140,-30,False
-2,224,152,154,2,False
-2,17,134,136,2,False
-2,316,160,150,-10,False
-2,109,142,144,2,False
-2,408,168,142,-26,False
-2,201,150,152,2,False
-2,500,176,134,-42,False
-2,293,158,152,-6,False
-2,86,140,142,2,False
-2,385,166,144,-22,False
-2,178,148,150,2,False
-2,477,174,136,-38,False
-2,270,156,154,-2,False
-2,63,138,140,2,False
-2,362,164,146,-18,False
-2,155,146,148,2,False
-2,454,172,138,-34,False
-2,247,154,156,2,False
-2,40,136,138,2,False
-2,339,162,148,-14,False
-2,132,144,146,2,False
-2,431,170,140,-30,False
-2,224,152,154,2,False
-2,17,134,136,2,False
-2,316,160,150,-10,False
-2,109,142,144,2,False
-2,408,168,142,-26,False
-2,201,150,152,2,False
-2,500,176,134,-42,False
-2,293,158,152,-6,False
-2,86,140,142,2,False
-2,385,166,144,-22,False
-2,178,148,150,2,False
-2,477,174,136,-38,False
-2,270,156,154,-2,False
-2,63,138,140,2,False
-2,362,164,146,-18,False
-2,155,146,148,2,False
-2,454,172,138,-34,False
-2,247,154,156,2,False
-2,40,136,138,2,False
-2,339,162,148,-14,False
-2,132,144,146,2,False
-2,431,170,140,-30,False
-2,224,152,154,2,False
-2,17,134,136,2,False
-2,316,160,150,-10,False
-2,109,142,144,2,False
-2,408,168,142,-26,False
-2,201,150,152,2,False
-2,500,176,134,-42,False
-2,293,158,152,-6,False
-2,86,140,142,2,False
-2,385,166,144,-22,False
-2,178,148,150,2,False
-2,477,174,136,-38,False
-2,270,156,154,-2,False
-2,63,138,140,2,False
-2,362,164,146,-18,False
-2,155,146,148,2,False
-2,454,172,138,-34,False
-2,247,154,156,2,False
-2,40,136,138,2,False
-2,339,162,148,-14,False
-2,132,144,146,2,False
-2,431,170,140,-30,False
-2,224,152,154,2,False
-2,17,134,136,2,False
-2,316,160,150,-10,False
-2,109,142,144,2,False
-2,408,168,142,-26,False
-2,201,150,152,2,False
-2,500,176,134,-42,False
-2,293,158,152,-6,False
-2,86,140,142,2,False
-2,385,166,144,-22,False
-2,178,148,150,2,False
-2,477,174,136,-38,False
-2,270,156,154,-2,False
-2,63,138,140,2,False
-2,362,164,146,-18,False
-2,155,146,148,2,False
-2,454,172,138,-34,False
-2,247,154,156,2,False
-2,40,136,138,2,False
-2,339,162,148,-14,False
-2,132,144,146,2,False
-2,431,170,140,-30,False
-2,224,152,154,2,False
-2,17,134,136,2,False
-2,316,160,150,-10,False
-2,109,142,144,2,False
-2,408,168,142,-26,False
-2,201,150,152,2,False
-2,500,176,134,-42,False
-2,293,158,152,-6,False
-2,86,140,142,2,False
-2,385,166,144,-22,False
-2,178,148,150,2,False
-2,477,174,136,-38,False
-2,270,156,154,-2,False
-2,63,138,140,2,False
-2,362,164,146,-18,False
-2,155,146,148,2,False
-2,454,172,138,-34,False
-2,247,154,156,2,False
-2,40,136,138,2,False
-2,339,162,148,-14,False
-2,132,144,146,2,False
-2,431,170,140,-30,False
-2,224,152,154,2,False
-2,17,134,136,2,False
-2,316,160,150,-10,False
-2,109,142,144,2,False
-2,408,168,142,-26,False
-2,201,150,152,2,False
-2,500,176,134,-42,False
-2,293,158,152,-6,False
-2,86,140,142,2,False
-2,385,166,144,-22,False
-2,178,148,150,2,False
-2,477,174,136,-38,False
-2,270,156,154,-2,False
-2,63,138,140,2,False
-2,362,164,146,-18,False
-2,155,146,148,2,False
-2,454,172,138,-34,False
-2,247,154,156,2,False
-2,40,136,138,2,False
-2,339,162,148,-14,False
-2,132,144,146,2,False
-2,431,170,140,-30,False
-2,224,152,154,2,False
-2,17,134,136,2,False
-2,316,160,150,-10,False
-2,109,142,144,2,False
-2,408,168,142,-26,False
-2,201,150,152,2,False
-2,500,176,134,-42,False
-2,293,158,152,-6,False
-2,86,140,142,2,False
-2,385,166,144,-22,False
-2,178,148,150,2,False
-2,477,174,136,-38,False
-2,270,156,154,-2,False
-2,63,138,140,2,False
-2,362,164,146,-18,False
-2,155,146,148,2,False
-2,454,172,138,-34,False
-2,247,154,156,2,False
-2,40,136,138,2,False
-2,339,162,148,-14,False
-2,132,144,146,2,False
-2,431,170,140,-30,False
-2,224,152,154,2,False
-2,17,134,136,2,False
-2,316,160,150,-10,False
-2,109,142,144,2,False
-2,408,168,142,-26,False
-2,201,150,152,2,False
-2,500,176,134,-42,False
-2,293,158,152,-6,False
-2,86,140,142,2,False
-2,385,166,144,-22,False
-2,178,148,150,2,False
-2,477,174,136,-38,False
-2,270,156,154,-2,False
-2,63,138,140,2,False
-2,362,164,146,-18,False
-2,155,146,148,2,False
-2,454,172,138,-34,False
-2,247,154,156,2,False
-2,40,136,138,2,False
-2,339,162,148,-14,False
-2,132,144,146,2,False
-2,431,170,140,-30,False
-2,224,152,154,2,False
-2,17,134,136,2,False
-2,316,160,150,-10,False
-2,109,142,144,2,False
-2,408,168,142,-26,False
-2,201,150,152,2,False
-2,500,176,134,-42,False
-2,293,158,152,-6,False
-2,86,140,142,2,False
-2,385,166,144,-22,False
-2,178,148,150,2,False
-2,477,174,136,-38,False
-2,270,156,154,-2,False
-2,63,138,140,2,False
-2,362,164,146,-18,False
-2,155,146,148,2,False
-2,454,172,138,-34,False
-2,247,154,156,2,False
-2,40,136,138,2,False
-2,339,162,148,-14,False
-2,132,144,146,2,False
-2,431,170,140,-30,False
-2,224,152,154,2,False
-2,17,134,136,2,False
-2,316,160,150,-10,False
-2,109,142,144,2,False
-2,408,168,142,-26,False
-2,201,150,152,2,False
-2,500,176,134,-42,False
-2,293,158,152,-6,False
-2,86,140,142,2,False
-2,385,166,144,-22,False
-2,178,148,150,2,False
-2,477,174,136,-38,False
-2,270,156,154,-2,False
-2,63,138,140,2,False
-2,362,164,146,-18,False
-2,155,146,148,2,False
-2,454,172,138,-34,False
-2,247,154,156,2,False
-2,40,136,138,2,False
-2,339,162,148,-14,False
-2,132,144,146,2,False
-2,431,170,140,-30,False
-2,224,152,154,2,False
-2,17,134,136,2,False
-2,316,160,150,-10,False
-2,109,142,144,2,False
-2,408,168,142,-26,False
-2,201,150,152,2,False
-2,500,176,134,-42,False
-2,293,158,152,-6,False
-2,86,140,142,2,False
-2,385,166,144,-22,False
-2,178,148,150,2,False
-2,477,174,136,-38,False
-2,270,156,154,-2,False
-2,63,138,140,2,False
-2,362,164,146,-18,False
-2,155,146,148,2,False
-2,454,172,138,-34,False
-2,247,154,156,2,False
-2,40,136,138,2,False
-2,339,162,148,-14,False
-2,132,144,146,2,False
-2,431,170,140,-30,False
-2,224,152,154,2,False
-2,17,134,136,2,False
-2,316,160,150,-10,False
-2,109,142,144,2,False
-2,408,168,142,-26,False
-2,201,150,152,2,False
-2,500,176,134,-42,False
-2,293,158,152,-6,False
-2,86,140,142,2,False
-2,385,166,144,-22,False
-2,178,148,150,2,False
-2,477,174,136,-38,False
-2,270,156,154,-2,False
-2,63,138,140,2,False
-2,362,164,146,-18,False
-2,155,146,148,2,False
-2,454,172,138,-34,False
-2,247,154,156,2,False
-2,40,136,138,2,False
-2,339,162,148,-14,False
-2,132,144,146,2,False
-2,431,170,140,-30,False
-2,224,152,154,2,False
-2,17,134,136,2,False
-2,316,160,150,-10,False
-2,109,142,144,2,False
-2,408,168,142,-26,False
-2,201,150,152,2,False
-2,500,176,134,-42,False
-2,293,158,152,-6,False
-2,86,140,142,2,False
-2,385,166,144,-22,False
-2,178,148,150,2,False
-2,477,174,136,-38,False
-2,270,156,154,-2,False
-2,63,138,140,2,False
-2,362,164,146,-18,False
-2,155,146,148,2,False
-2,454,172,138,-34,False
-2,247,154,156,2,False
-2,40,136,138,2,False
-2,339,162,148,-14,False
-2,132,144,146,2,False
-2,431,170,140,-30,False
-2,224,152,154,2,False
-2,17,134,136,2,False
-2,316,160,150,-10,False
-2,109,142,144,2,False
-2,408,168,142,-26,False
-2,201,150,152,2,False
-2,500,176,134,-42,False
-2,293,158,152,-6,False
-2,86,140,142,2,False
-2,385,166,144,-22,False
-2,178,148,150,2,False
-2,477,174,136,-38,False
-2,270,156,154,-2,False
-2,63,138,140,2,False
-2,362,164,146,-18,False
-2,155,146,148,2,False
-2,454,172,138,-34,False
-2,247,154,156,2,False
-2,40,136,138,2,False
-2,339,162,148,-14,False
-2,132,144,146,2,False
-2,431,170,140,-30,False
-2,224,152,154,2,False
-2,17,134,136,2,False
-2,316,160,150,-10,False
-2,109,142,144,2,False
-2,408,168,142,-26,False
-2,201,150,152,2,False
-2,500,176,134,-42,False
-2,293,158,152,-6,False
-2,86,140,142,2,False
-2,385,166,144,-22,False
-2,178,148,150,2,False
-2,477,174,136,-38,False
-2,270,156,154,-2,False
-2,63,138,140,2,False
-2,362,164,146,-18,False
-2,155,146,148,2,False
-2,454,172,138,-34,False
-2,247,154,156,2,False
-2,40,136,138,2,False
-2,339,162,148,-14,False
-2,132,144,146,2,False
-2,431,170,140,-30,False
-2,224,152,154,2,False
-2,17,134,136,2,False
-2,316,160,150,-10,False
-2,109,142,144,2,False
-2,408,168,142,-26,False
-2,201,150,152,2,False
-2,500,176,134,-42,False
-2,293,158,152,-6,False
-2,86,140,142,2,False
-2,385,166,144,-22,False
-2,178,148,150,2,False
-2,477,174,136,-38,False
-2,270,156,154,-2,False
-2,63,138,140,2,False
-2,362,164,146,-18,False
-2,155,146,148,2,False
-2,454,172,138,-34,False
-2,247,154,156,2,False
-2,40,136,138,2,False
-2,339,162,148,-14,False
-2,132,144,146,2,False
-2,431,170,140,-30,False
-2,224,152,154,2,False
-2,17,134,136,2,False
-2,316,160,150,-10,False
-2,109,142,144,2,False
-2,408,168,142,-26,False
-2,201,150,152,2,False
-2,500,176,134,-42,False
-2,293,158,152,-6,False
-2,86,140,142,2,False
-2,385,166,144,-22,False
-2,178,148,150,2,False
-2,477,174,136,-38,False
-2,270,156,154,-2,False
-2,63,138,140,2,False
-2,362,164,146,-18,False
-2,155,146,148,2,False
-2,454,172,138,-34,False
-2,247,154,156,2,False
-2,40,136,138,2,False
-2,339,162,148,-14,False
-2,132,144,146,2,False
-2,431,170,140,-30,False
-2,224,152,154,2,False
-2,17,134,136,2,False
-2,316,160,150,-10,False
-2,109,142,144,2,False
-2,408,168,142,-26,False
-2,201,150,152,2,False
-2,500,176,134,-42,False
-2,293,158,152,-6,False
-2,86,140,142,2,False
-2,385,166,144,-22,False
-2,178,148,150,2,False
-2,477,174,136,-38,False
-2,270,156,154,-2,False
-2,63,138,140,2,False
-2,362,164,146,-18,False
-2,155,146,148,2,False
-2,454,172,138,-34,False
-2,247,154,156,2,False
-2,40,136,138,2,False
-2,339,162,148,-14,False
-2,132,144,146,2,False
-2,431,170,140,-30,False
-2,224,152,154,2,False
-2,17,134,136,2,False
-2,316,160,150,-10,False
-2,109,142,144,2,False
-2,408,168,142,-26,False
-2,201,150,152,2,False
-2,500,176,134,-42,False
-2,293,158,152,-6,False
-2,86,140,142,2,False
-2,385,166,144,-22,False
-2,178,148,150,2,False
-2,477,174,136,-38,False
-2,270,156,154,-2,False
-2,63,138,140,2,False
-2,362,164,146,-18,False
-2,155,146,148,2,False
-2,454,172,138,-34,False
-2,247,154,156,2,False
-2,40,136,138,2,False
-2,339,162,148,-14,False
-2,132,144,146,2,False
-2,431,170,140,-30,False
-2,224,152,154,2,False
-2,17,134,136,2,False
-2,316,160,150,-10,False
-2,109,142,144,2,False
-2,408,168,142,-26,False
-2,201,150,152,2,False
-2,500,176,134,-42,False
-2,293,158,152,-6,False
-2,86,140,142,2,False
-2,385,166,144,-22,False
-2,178,148,150,2,False
-2,477,174,136,-38,False
-2,270,156,154,-2,False
-2,63,138,140,2,False
-2,362,164,146,-18,False
-2,155,146,148,2,False
-2,454,172,138,-34,False
-2,247,154,156,2,False
-2,40,136,138,2,False
-2,339,162,148,-14,False
-2,132,144,146,2,False
-2,431,170,140,-30,False
-2,224,152,154,2,False
-2,17,134,136,2,False
-2,316,160,150,-10,False
-2,109,142,144,2,False
-2,408,168,142,-26,False
-2,201,150,152,2,False
-2,500,176,134,-42,False
-2,293,158,152,-6,False
-2,86,140,142,2,False
-2,385,166,144,-22,False
-2,178,148,150,2,False
-2,477,174,136,-38,False
-2,270,156,154,-2,False
-2,63,138,140,2,False
-2,362,164,146,-18,False
-2,155,146,148,2,False
-2,454,172,138,-34,False
-2,247,154,156,2,False
-2,40,136,138,2,False
-2,339,162,148,-14,False
-2,132,144,146,2,False
-2,431,170,140,-30,False
-2,224,152,154,2,False
-2,17,134,136,2,False
-2,316,160,150,-10,False
-2,109,142,144,2,False
-2,408,168,142,-26,False
-2,201,150,152,2,False
-2,500,176,134,-42,False
-2,293,158,152,-6,False
-2,86,140,142,2,False
-2,385,166,144,-22,False
-2,178,148,150,2,False
-2,477,174,136,-38,False
-2,270,156,154,-2,False
-2,63,138,140,2,False
-2,362,164,146,-18,False
-2,155,146,148,2,False
-2,454,172,138,-34,False
-2,247,154,156,2,False
-2,40,136,138,2,False
-2,339,162,148,-14,False
-2,132,144,146,2,False
-2,431,170,140,-30,False
-2,224,152,154,2,False
-2,17,134,136,2,False
-2,316,160,150,-10,False
-2,109,142,144,2,False
-2,408,168,142,-26,False
-2,201,150,152,2,False
-2,500,176,134,-42,False
-2,293,158,152,-6,False
-2,86,140,142,2,False
-2,385,166,144,-22,False
-2,178,148,150,2,False
-2,477,174,136,-38,False
-2,270,156,154,-2,False
-2,63,138,140,2,False
-2,362,164,146,-18,False
-2,155,146,148,2,False
-2,454,172,138,-34,False
-2,247,154,156,2,False
-2,40,136,138,2,False
-2,339,162,148,-14,False
-2,132,144,146,2,False
-2,431,170,140,-30,False
-2,224,152,154,2,False
-2,17,134,136,2,False
-2,316,160,150,-10,False
-2,109,142,144,2,False
-2,408,168,142,-26,False
-2,201,150,152,2,False
-2,500,176,134,-42,False
-2,293,158,152,-6,False
-2,86,140,142,2,False
-2,385,166,144,-22,False
-2,178,148,150,2,False
-2,477,174,136,-38,False
-2,270,156,154,-2,False
-2,63,138,140,2,False
-2,362,164,146,-18,False
-2,155,146,148,2,False
-2,454,172,138,-34,False
-2,247,154,156,2,False
-2,40,136,138,2,False
-2,339,162,148,-14,False
-2,132,144,146,2,False
-2,431,170,140,-30,False
-2,224,152,154,2,False
-2,17,134,136,2,False
-2,316,160,150,-10,False
-2,109,142,144,2,False
-2,408,168,142,-26,False
-2,201,150,152,2,False
-2,500,176,134,-42,False
-2,293,158,152,-6,False
-2,86,140,142,2,False
-2,385,166,144,-22,False
-2,178,148,150,2,False
-2,477,174,136,-38,False
-2,270,156,154,-2,False
-2,63,138,140,2,False
-2,362,164,146,-18,False
-2,155,146,148,2,False
-2,454,172,138,-34,False
-2,247,154,156,2,False
-2,40,136,138,2,False
-2,339,162,148,-14,False
-2,132,144,146,2,False
-2,431,170,140,-30,False
-2,224,152,154,2,False
-2,17,134,136,2,False
-2,316,160,150,-10,False
-2,109,142,144,2,False
-2,408,168,142,-26,False
-2,201,150,152,2,False
-2,500,176,134,-42,False
-2,293,158,152,-6,False
-2,86,140,142,2,False
-2,385,166,144,-22,False
-2,178,148,150,2,False
-2,477,174,136,-38,False
-2,270,156,154,-2,False
-2,63,138,140,2,False
-2,362,164,146,-18,False
-2,155,146,148,2,False
-2,454,172,138,-34,False
-2,247,154,156,2,False
-2,40,136,138,2,False
-2,339,162,148,-14,False
-2,132,144,146,2,False
-2,431,170,140,-30,False
-2,224,152,154,2,False
-2,17,134,136,2,False
-2,316,160,150,-10,False
-2,109,142,144,2,False
-2,408,168,142,-26,False
-2,201,150,152,2,False
-2,500,176,134,-42,False
-2,293,158,152,-6,False
-2,86,140,142,2,False
-2,385,166,144,-22,False
-2,178,148,150,2,False
-2,477,174,136,-38,False
-2,270,156,154,-2,False
-2,63,138,140,2,False
-2,362,164,146,-18,False
-2,155,146,148,2,False
-2,454,172,138,-34,False
-2,247,154,156,2,False
-2,40,136,138,2,False
-2,339,162,148,-14,False
-2,132,144,146,2,False
-2,431,170,140,-30,False
-2,224,152,154,2,False
-2,17,134,136,2,False
-2,316,160,150,-10,False
-2,109,142,144,2,False
-2,408,168,142,-26,False
-2,201,150,152,2,False
-2,500,176,134,-42,False
-2,293,158,152,-6,False
-2,86,140,142,2,False
-2,385,166,144,-22,False
-2,178,148,150,2,False
-2,477,174,136,-38,False
-2,270,156,154,-2,False
-2,63,138,140,2,False
-2,362,164,146,-18,False
-2,155,146,148,2,False
-2,454,172,138,-34,False
-2,247,154,156,2,False
-2,40,136,138,2,False
-2,339,162,148,-14,False
-2,132,144,146,2,False
-2,431,170,140,-30,False
-2,224,152,154,2,False
-2,17,134,136,2,False
-2,316,160,150,-10,False
-2,109,142,144,2,False
-2,408,168,142,-26,False
-2,201,150,152,2,False
-2,500,176,134,-42,False
-2,293,158,152,-6,False
-2,86,140,142,2,False
-2,385,166,144,-22,False
-2,178,148,150,2,False
-2,477,174,136,-38,False
-2,270,156,154,-2,False
-2,63,138,140,2,False
-2,362,164,146,-18,False
-2,155,146,148,2,False
-2,454,172,138,-34,False
-2,247,154,156,2,False
-2,40,136,138,2,False
-2,339,162,148,-14,False
-2,132,144,146,2,False
-2,431,170,140,-30,False
-2,224,152,154,2,False
-2,17,134,136,2,False
-2,316,160,150,-10,False
-2,109,142,144,2,False
-2,408,168,142,-26,False
-2,201,150,152,2,False
-2,500,176,134,-42,False
-2,293,158,152,-6,False
-2,86,140,142,2,False
-2,385,166,144,-22,False
-2,178,148,150,2,False
-2,477,174,136,-38,False
-2,270,156,154,-2,False
-2,63,138,140,2,False
-2,362,164,146,-18,False
-2,155,146,148,2,False
-2,454,172,138,-34,False
-2,247,154,156,2,False
-2,40,136,138,2,False
-2,339,162,148,-14,False
-2,132,144,146,2,False
-2,431,170,140,-30,False
-2,224,152,154,2,False
-2,17,134,136,2,False
-2,316,160,150,-10,False
-2,109,142,144,2,False
-2,408,168,142,-26,False
-2,201,150,152,2,False
-2,500,176,134,-42,False
-2,293,158,152,-6,False
-2,86,140,142,2,False
-2,385,166,144,-22,False
-2,178,148,150,2,False
-2,477,174,136,-38,False
-2,270,156,154,-2,False
-2,63,138,140,2,False
-2,362,164,146,-18,False
-2,155,146,148,2,False
-2,454,172,138,-34,False
-2,247,154,156,2,False
-2,40,136,138,2,False
-2,339,162,148,-14,False
-2,132,144,146,2,False
-2,431,170,140,-30,False
-2,224,152,154,2,False
-2,17,134,136,2,False
-2,316,160,150,-10,False
-2,109,142,144,2,False
-2,408,168,142,-26,False
-2,201,150,152,2,False
-2,500,176,134,-42,False
-2,293,158,152,-6,False
-2,86,140,142,2,False
-2,385,166,144,-22,False
-2,178,148,150,2,False
-2,477,174,136,-38,False
-2,270,156,154,-2,False
-2,63,138,140,2,False
-2,362,164,146,-18,False
-2,155,146,148,2,False
-2,454,172,138,-34,False
-2,247,154,156,2,False
-2,40,136,138,2,False
-2,339,162,148,-14,False
-2,132,144,146,2,False
-2,431,170,140,-30,False
-2,224,152,154,2,False
-2,17,134,136,2,False
-2,316,160,150,-10,False
-2,109,142,144,2,False
-2,408,168,142,-26,False
-2,201,150,152,2,False
-2,500,176,134,-42,False
-2,293,158,152,-6,False
-2,86,140,142,2,False
-2,385,166,144,-22,False
-2,178,148,150,2,False
-2,477,174,136,-38,False
-2,270,156,154,-2,False
-2,63,138,140,2,False
-2,362,164,146,-18,False
-2,155,146,148,2,False
-2,454,172,138,-34,False
-2,247,154,156,2,False
-2,40,136,138,2,False
-2,339,162,148,-14,False
-2,132,144,146,2,False
-2,431,170,140,-30,False
-2,224,152,154,2,False
-2,17,134,136,2,False
-2,316,160,150,-10,False
-2,109,142,144,2,False
-2,408,168,142,-26,False
-2,201,150,152,2,False
-2,500,176,134,-42,False
-2,293,158,152,-6,False
-2,86,140,142,2,False
-2,385,166,144,-22,False
-2,178,148,150,2,False
-2,477,174,136,-38,False
-2,270,156,154,-2,False
-2,63,138,140,2,False
-2,362,164,146,-18,False
-2,155,146,148,2,False
-2,454,172,138,-34,False
-2,247,154,156,2,False
-2,40,136,138,2,False
-2,339,162,148,-14,False
-2,132,144,146,2,False
-2,431,170,140,-30,False
-2,224,152,154,2,False
-2,17,134,136,2,False
-2,316,160,150,-10,False
-2,109,142,144,2,False
-2,408,168,142,-26,False
-2,201,150,152,2,False
-2,500,176,134,-42,False
-2,293,158,152,-6,False
-2,86,140,142,2,False
-2,385,166,144,-22,False
-2,178,148,150,2,False
-2,477,174,136,-38,False
-2,270,156,154,-2,False
-2,63,138,140,2,False
-2,362,164,146,-18,False
-2,155,146,148,2,False
-2,454,172,138,-34,False
-2,247,154,156,2,False
-2,40,136,138,2,False
-2,339,162,148,-14,False
-2,132,144,146,2,False
-2,431,170,140,-30,False
-2,224,152,154,2,False
-2,17,134,136,2,False
-2,316,160,150,-10,False
-2,109,142,144,2,False
-2,408,168,142,-26,False
-2,201,150,152,2,False
-2,500,176,134,-42,False
-2,293,158,152,-6,False
-2,86,140,142,2,False
-2,385,166,144,-22,False
-2,178,148,150,2,False
-2,477,174,136,-38,False
-2,270,156,154,-2,False
-2,63,138,140,2,False
-2,362,164,146,-18,False
-2,155,146,148,2,False
-2,454,172,138,-34,False
-2,247,154,156,2,False
-2,40,136,138,2,False
-2,339,162,148,-14,False
-2,132,144,146,2,False
-2,431,170,140,-30,False
-2,224,152,154,2,False
-2,17,134,136,2,False
-2,316,160,150,-10,False
-2,109,142,144,2,False
-2,408,168,142,-26,False
-2,201,150,152,2,False
-2,500,176,134,-42,False
-2,293,158,152,-6,False
-2,86,140,142,2,False
-2,385,166,144,-22,False
-2,178,148,150,2,False
-2,477,174,136,-38,False
-2,270,156,154,-2,False
-2,63,138,140,2,False
-2,362,164,146,-18,False
-2,155,146,148,2,False
-2,454,172,138,-34,False
-2,247,154,156,2,False
-2,40,136,138,2,False
-2,339,162,148,-14,False
-2,132,144,146,2,False
-2,431,170,140,-30,False
-2,224,152,154,2,False
-2,17,134,136,2,False
-2,316,160,150,-10,False
-2,109,142,144,2,False
-2,408,168,142,-26,False
-2,201,150,152,2,False
-2,500,176,134,-42,False
-2,293,158,152,-6,False
-2,86,140,142,2,False
-2,385,166,144,-22,False
-2,178,148,150,2,False
-2,477,174,136,-38,False
-2,270,156,154,-2,False
-2,63,138,140,2,False
-2,362,164,146,-18,False
-2,155,146,148,2,False
-2,454,172,138,-34,False
-2,247,154,156,2,False
-2,40,136,138,2,False
-2,339,162,148,-14,False
-2,132,144,146,2,False
-2,431,170,140,-30,False
-2,224,152,154,2,False
-2,17,134,136,2,False
-2,316,160,150,-10,False
-2,109,142,144,2,False
-2,408,168,142,-26,False
-2,201,150,152,2,False
-2,500,176,134,-42,False
-2,293,158,152,-6,False
-2,86,140,142,2,False
-2,385,166,144,-22,False
-2,178,148,150,2,False
-2,477,174,136,-38,False
-2,270,156,154,-2,False
-2,63,138,140,2,False
-2,362,164,146,-18,False
-2,155,146,148,2,False
-2,454,172,138,-34,False
-2,247,154,156,2,False
-2,40,136,138,2,False
-2,339,162,148,-14,False
-2,132,144,146,2,False
-2,431,170,140,-30,False
-2,224,152,154,2,False
-2,17,134,136,2,False
-2,316,160,150,-10,False
-2,109,142,144,2,False
-2,408,168,142,-26,False
-2,201,150,152,2,False
-2,500,176,134,-42,False
-2,293,158,152,-6,False
-2,86,140,142,2,False
-2,385,166,144,-22,False
-2,178,148,150,2,False
-2,477,174,136,-38,False
-2,270,156,154,-2,False
-2,63,138,140,2,False
-2,362,164,146,-18,False
-2,155,146,148,2,False
-2,454,172,138,-34,False
-2,247,154,156,2,False
-2,40,136,138,2,False
-2,339,162,148,-14,False
-2,132,144,146,2,False
-2,431,170,140,-30,False
-2,224,152,154,2,False
-2,17,134,136,2,False
-2,316,160,150,-10,False
-2,109,142,144,2,False
-2,408,168,142,-26,False
-2,201,150,152,2,False
-2,500,176,134,-42,False
-2,293,158,152,-6,False
-2,86,140,142,2,False
-2,385,166,144,-22,False
-2,178,148,150,2,False
-2,477,174,136,-38,False
-2,270,156,154,-2,False
-2,63,138,140,2,False
-2,362,164,146,-18,False
-2,155,146,148,2,False
-2,454,172,138,-34,False
-2,247,154,156,2,False
-2,40,136,138,2,False
-2,339,162,148,-14,False
-2,132,144,146,2,False
-2,431,170,140,-30,False
-2,224,152,154,2,False
-2,17,134,136,2,False
-2,316,160,150,-10,False
-2,109,142,144,2,False
-2,408,168,142,-26,False
-2,201,150,152,2,False
-2,500,176,134,-42,False
-2,293,158,152,-6,False
-2,86,140,142,2,False
-2,385,166,144,-22,False
-2,178,148,150,2,False
-2,477,174,136,-38,False
-2,270,156,154,-2,False
-2,63,138,140,2,False
-2,362,164,146,-18,False
-2,155,146,148,2,False
-2,454,172,138,-34,False
-2,247,154,156,2,False
-2,40,136,138,2,False
-2,339,162,148,-14,False
-2,132,144,146,2,False
-2,431,170,140,-30,False
-2,224,152,154,2,False
-2,17,134,136,2,False
-2,316,160,150,-10,False
-2,109,142,144,2,False
-2,408,168,142,-26,False
-2,201,150,152,2,False
-2,500,176,134,-42,False
-2,293,158,152,-6,False
-2,86,140,142,2,False
-2,385,166,144,-22,False
-2,178,148,150,2,False
-2,477,174,136,-38,False
-2,270,156,154,-2,False
-2,63,138,140,2,False
-2,362,164,146,-18,False
-2,155,146,148,2,False
-2,454,172,138,-34,False
-2,247,154,156,2,False
-2,40,136,138,2,False
-2,339,162,148,-14,False
-2,132,144,146,2,False
-2,431,170,140,-30,False
-2,224,152,154,2,False
-2,17,134,136,2,False
-2,316,160,150,-10,False
-2,109,142,144,2,False
-2,408,168,142,-26,False
-2,201,150,152,2,False
-2,500,176,134,-42,False
-2,293,158,152,-6,False
-2,86,140,142,2,False
-2,385,166,144,-22,False
-2,178,148,150,2,False
-2,477,174,136,-38,False
-2,270,156,154,-2,False
-2,63,138,140,2,False
-2,362,164,146,-18,False
-2,155,146,148,2,False
-2,454,172,138,-34,False
-2,247,154,156,2,False
-2,40,136,138,2,False
-2,339,162,148,-14,False
-2,132,144,146,2,False
-2,431,170,140,-30,False
-2,224,152,154,2,False
-2,17,134,136,2,False
-2,316,160,150,-10,False
-2,109,142,144,2,False
-2,408,168,142,-26,False
-2,201,150,152,2,False
-2,500,176,134,-42,False
-2,293,158,152,-6,False
-2,86,140,142,2,False
-2,385,166,144,-22,False
-2,178,148,150,2,False
-2,477,174,136,-38,False
-2,270,156,154,-2,False
-2,63,138,140,2,False
-2,362,164,146,-18,False
-2,155,146,148,2,False
-2,454,172,138,-34,False
-2,247,154,156,2,False
-2,40,136,138,2,False
-2,339,162,148,-14,False
-2,132,144,146,2,False
-2,431,170,140,-30,False
-2,224,152,154,2,False
-2,17,134,136,2,False
-2,316,160,150,-10,False
-2,109,142,144,2,False
-2,408,168,142,-26,False
-2,201,150,152,2,False
-2,500,176,134,-42,False
-2,293,158,152,-6,False
-2,86,140,142,2,False
-2,385,166,144,-22,False
-2,178,148,150,2,False
-2,477,174,136,-38,False
-2,270,156,154,-2,False
-2,63,138,140,2,False
-2,362,164,146,-18,False
-2,155,146,148,2,False
-2,454,172,138,-34,False
-2,247,154,156,2,False
-2,40,136,138,2,False
-2,339,162,148,-14,False
-2,132,144,146,2,False
-2,431,170,140,-30,False
-2,224,152,154,2,False
-2,17,134,136,2,False
-2,316,160,150,-10,False
-2,109,142,144,2,False
-2,408,168,142,-26,False
-2,201,150,152,2,False
-2,500,176,134,-42,False
-2,293,158,152,-6,False
-2,86,140,142,2,False
-2,385,166,144,-22,False
-2,178,148,150,2,False
-2,477,174,136,-38,False
-2,270,156,154,-2,False
-2,63,138,140,2,False
-2,362,164,146,-18,False
-2,155,146,148,2,False
-2,454,172,138,-34,False
-2,247,154,156,2,False
-2,40,136,138,2,False
-2,339,162,148,-14,False
-2,132,144,146,2,False
-2,431,170,140,-30,False
-2,224,152,154,2,False
-2,17,134,136,2,False
-2,316,160,150,-10,False
-2,109,142,144,2,False
-2,408,168,142,-26,False
-2,201,150,152,2,False
-2,500,176,134,-42,False
-2,293,158,152,-6,False
-2,86,140,142,2,False
-2,385,166,144,-22,False
-2,178,148,150,2,False
-2,477,174,136,-38,False
-2,270,156,154,-2,False
-2,63,138,140,2,False
-2,362,164,146,-18,False
-2,155,146,148,2,False
-2,454,172,138,-34,False
-2,247,154,156,2,False
-2,40,136,138,2,False
-2,339,162,148,-14,False
-2,132,144,146,2,False
-2,431,170,140,-30,False
-2,224,152,154,2,False
-2,17,134,136,2,False
-2,316,160,150,-10,False
-2,109,142,144,2,False
-2,408,168,142,-26,False
-2,201,150,152,2,False
-2,500,176,134,-42,False
-2,293,158,152,-6,False
-2,86,140,142,2,False
-2,385,166,144,-22,False
-2,178,148,150,2,False
-2,477,174,136,-38,False
-2,270,156,154,-2,False
-2,63,138,140,2,False
-2,362,164,146,-18,False
-2,155,146,148,2,False
-2,454,172,138,-34,False
-2,247,154,156,2,False
-2,40,136,138,2,False
-2,339,162,148,-14,False
-2,132,144,146,2,False
-2,431,170,140,-30,False
-2,224,152,154,2,False
-2,17,134,136,2,False
-2,316,160,150,-10,False
-2,109,142,144,2,False
-2,408,168,142,-26,False
-2,201,150,152,2,False
-2,500,176,134,-42,False
-2,293,158,152,-6,False
-2,86,140,142,2,False
-2,385,166,144,-22,False
-2,178,148,150,2,False
-2,477,174,136,-38,False
-2,270,156,154,-2,False
-2,63,138,140,2,False
-2,362,164,146,-18,False
-2,155,146,148,2,False
-2,454,172,138,-34,False
-2,247,154,156,2,False
-2,40,136,138,2,False
-2,339,162,148,-14,False
-2,132,144,146,2,False
-2,431,170,140,-30,False
-2,224,152,154,2,False
-2,17,134,136,2,False
-2,316,160,150,-10,False
-2,109,142,144,2,False
-2,408,168,142,-26,False
-2,201,150,152,2,False
-2,500,176,134,-42,False
-2,293,158,152,-6,False
-2,86,140,142,2,False
-2,385,166,144,-22,False
-2,178,148,150,2,False
-2,477,174,136,-38,False
-2,270,156,154,-2,False
-2,63,138,140,2,False
-2,362,164,146,-18,False
-2,155,146,148,2,False
-2,454,172,138,-34,False
-2,247,154,156,2,False
-2,40,136,138,2,False
-2,339,162,148,-14,False
-2,132,144,146,2,False
-2,431,170,140,-30,False
-2,224,152,154,2,False
-2,17,134,136,2,False
-2,316,160,150,-10,False
-2,109,142,144,2,False
-2,408,168,142,-26,False
-2,201,150,152,2,False
-2,500,176,134,-42,False
-2,293,158,152,-6,False
-2,86,140,142,2,False
-2,385,166,144,-22,False
-2,178,148,150,2,False
-2,477,174,136,-38,False
-2,270,156,154,-2,False
-2,63,138,140,2,False
-2,362,164,146,-18,False
-2,155,146,148,2,False
-2,454,172,138,-34,False
-2,247,154,156,2,False
-2,40,136,138,2,False
-2,339,162,148,-14,False
-2,132,144,146,2,False
-2,431,170,140,-30,False
-2,224,152,154,2,False
-2,17,134,136,2,False
-2,316,160,150,-10,False
-2,109,142,144,2,False
-2,408,168,142,-26,False
-2,201,150,152,2,False
-2,500,176,134,-42,False
-2,293,158,152,-6,False
-2,86,140,142,2,False
-2,385,166,144,-22,False
-2,178,148,150,2,False
-2,477,174,136,-38,False
-2,270,156,154,-2,False
-2,63,138,140,2,False
-2,362,164,146,-18,False
-2,155,146,148,2,False
-2,454,172,138,-34,False
-2,247,154,156,2,False
-2,40,136,138,2,False
-2,339,162,148,-14,False
-2,132,144,146,2,False
-2,431,170,140,-30,False
-2,224,152,154,2,False
-2,17,134,136,2,False
-2,316,160,150,-10,False
-2,109,142,144,2,False
-2,408,168,142,-26,False
-2,201,150,152,2,False
-2,500,176,134,-42,False
-2,293,158,152,-6,False
-2,86,140,142,2,False
-2,385,166,144,-22,False
-2,178,148,150,2,False
-2,477,174,136,-38,False
-2,270,156,154,-2,False
-2,63,138,140,2,False
-2,362,164,146,-18,False
-2,155,146,148,2,False
-2,454,172,138,-34,False
-2,247,154,156,2,False
-2,40,136,138,2,False
-2,339,162,148,-14,False
-2,132,144,146,2,False
-2,431,170,140,-30,False
-2,224,152,154,2,False
-2,17,134,136,2,False
-2,316,160,150,-10,False
-2,109,142,144,2,False
-2,408,168,142,-26,False
-2,201,150,152,2,False
-2,500,176,134,-42,False
-2,293,158,152,-6,False
-2,86,140,142,2,False
-2,385,166,144,-22,False
-2,178,148,150,2,False
-2,477,174,136,-38,False
-2,270,156,154,-2,False
-2,63,138,140,2,False
-2,362,164,146,-18,False
-2,155,146,148,2,False
-2,454,172,138,-34,False
-2,247,154,156,2,False
-2,40,136,138,2,False
-2,339,162,148,-14,False
-2,132,144,146,2,False
-2,431,170,140,-30,False
-2,224,152,154,2,False
-2,17,134,136,2,False
-2,316,160,150,-10,False
-2,109,142,144,2,False
-2,408,168,142,-26,False
-2,201,150,152,2,False
-2,500,176,134,-42,False
-2,293,158,152,-6,False
-2,86,140,142,2,False
-2,385,166,144,-22,False
-2,178,148,150,2,False
-2,477,174,136,-38,False
-2,270,156,154,-2,False
-2,63,138,140,2,False
-2,362,164,146,-18,False
-2,155,146,148,2,False
-2,454,172,138,-34,False
-2,247,154,156,2,False
-2,40,136,138,2,False
-2,339,162,148,-14,False
-2,132,144,146,2,False
-2,431,170,140,-30,False
-2,224,152,154,2,False
-2,17,134,136,2,False
-2,316,160,150,-10,False
-2,109,142,144,2,False
-2,408,168,142,-26,False
-2,201,150,152,2,False
-2,500,176,134,-42,False
-2,293,158,152,-6,False
-2,86,140,142,2,False
-2,385,166,144,-22,False
-2,178,148,150,2,False
-2,477,174,136,-38,False
-2,270,156,154,-2,False
-2,63,138,140,2,False
-2,362,164,146,-18,False
-2,155,146,148,2,False
-2,454,172,138,-34,False
-2,247,154,156,2,False
-2,40,136,138,2,False
-2,339,162,148,-14,False
-2,132,144,146,2,False
-2,431,170,140,-30,False
-2,224,152,154,2,False
-2,17,134,136,2,False
-2,316,160,150,-10,False
-2,109,142,144,2,False
-2,408,168,142,-26,False
-2,201,150,152,2,False
-2,500,176,134,-42,False
-2,293,158,152,-6,False
-2,86,140,142,2,False
-2,385,166,144,-22,False
-2,178,148,150,2,False
-2,477,174,136,-38,False
-2,270,156,154,-2,False
-2,63,138,140,2,False
-2,362,164,146,-18,False
-2,155,146,148,2,False
-2,454,172,138,-34,False
-2,247,154,156,2,False
-2,40,136,138,2,False
-2,339,162,148,-14,False
-2,132,144,146,2,False
-2,431,170,140,-30,False
-2,224,152,154,2,False
-2,17,134,136,2,False
-2,316,160,150,-10,False
-2,109,142,144,2,False
-2,408,168,142,-26,False
-2,201,150,152,2,False
-2,500,176,134,-42,False
-2,293,158,152,-6,False
-2,86,140,142,2,False
-2,385,166,144,-22,False
-2,178,148,150,2,False
-2,477,174,136,-38,False
-2,270,156,154,-2,False
-2,63,138,140,2,False
-2,362,164,146,-18,False
-2,155,146,148,2,False
-2,454,172,138,-34,False
-2,247,154,156,2,False
-2,40,136,138,2,False
-2,339,162,148,-14,False
-2,132,144,146,2,False
-2,431,170,140,-30,False
-2,224,152,154,2,False
-2,17,134,136,2,False
-2,316,160,150,-10,False
-2,109,142,144,2,False
-2,408,168,142,-26,False
-2,201,150,152,2,False
-2,500,176,134,-42,False
-2,293,158,152,-6,False
-2,86,140,142,2,False
-2,385,166,144,-22,False
-2,178,148,150,2,False
-2,477,174,136,-38,False
-2,270,156,154,-2,False
-2,63,138,140,2,False
-2,362,164,146,-18,False
-2,155,146,148,2,False
-2,454,172,138,-34,False
-2,247,154,156,2,False
-2,40,136,138,2,False
-2,339,162,148,-14,False
-2,132,144,146,2,False
-2,431,170,140,-30,False
-2,224,152,154,2,False
-2,17,134,136,2,False
-2,316,160,150,-10,False
-2,109,142,144,2,False
-2,408,168,142,-26,False
-2,201,150,152,2,False
-2,500,176,134,-42,False
-2,293,158,152,-6,False
-2,86,140,142,2,False
-2,385,166,144,-22,False
-2,178,148,150,2,False
-2,477,174,136,-38,False
-2,270,156,154,-2,False
-2,63,138,140,2,False
-2,362,164,146,-18,False
-2,155,146,148,2,False
-2,454,172,138,-34,False
-2,247,154,156,2,False
-2,40,136,138,2,False
-2,339,162,148,-14,False
-2,132,144,146,2,False
-2,431,170,140,-30,False
-2,224,152,154,2,False
-2,17,134,136,2,False
-2,316,160,150,-10,False
-2,109,142,144,2,False
-2,408,168,142,-26,False
-2,201,150,152,2,False
-2,500,176,134,-42,False
-2,293,158,152,-6,False
-2,86,140,142,2,False
-2,385,166,144,-22,False
-2,178,148,150,2,False
-2,477,174,136,-38,False
-2,270,156,154,-2,False
-2,63,138,140,2,False
-2,362,164,146,-18,False
-2,155,146,148,2,False
-2,454,172,138,-34,False
-2,247,154,156,2,False
-2,40,136,138,2,False
-2,339,162,148,-14,False
-2,132,144,146,2,False
-2,431,170,140,-30,False
-2,224,152,154,2,False
-2,17,134,136,2,False
-2,316,160,150,-10,False
-2,109,142,144,2,False
-2,408,168,142,-26,False
-2,201,150,152,2,False
-2,500,176,134,-42,False
-2,293,158,152,-6,False
-2,86,140,142,2,False
-2,385,166,144,-22,False
-2,178,148,150,2,False
-2,477,174,136,-38,False
-2,270,156,154,-2,False
-2,63,138,140,2,False
-2,362,164,146,-18,False
-2,155,146,148,2,False
-2,454,172,138,-34,False
-2,247,154,156,2,False
-2,40,136,138,2,False
-2,339,162,148,-14,False
-2,132,144,146,2,False
-2,431,170,140,-30,False
-2,224,152,154,2,False
-2,17,134,136,2,False
-2,316,160,150,-10,False
-2,109,142,144,2,False
-2,408,168,142,-26,False
-2,201,150,152,2,False
-2,500,176,134,-42,False
-2,293,158,152,-6,False
-2,86,140,142,2,False
-2,385,166,144,-22,False
-2,178,148,150,2,False
-2,477,174,136,-38,False
-2,270,156,154,-2,False
-2,63,138,140,2,False
-2,362,164,146,-18,False
-2,155,146,148,2,False
-2,454,172,138,-34,False
-2,247,154,156,2,False
-2,40,136,138,2,False
-2,339,162,148,-14,False
-2,132,144,146,2,False
-2,431,170,140,-30,False
-2,224,152,154,2,False
-2,17,134,136,2,False
-2,316,160,150,-10,False
-2,109,142,144,2,False
-2,408,168,142,-26,False
-2,201,150,152,2,False
-2,500,176,134,-42,False
-2,293,158,152,-6,False
-2,86,140,142,2,False
-2,385,166,144,-22,False
-2,178,148,150,2,False
-2,477,174,136,-38,False
-2,270,156,154,-2,False
-2,63,138,140,2,False
-2,362,164,146,-18,False
-2,155,146,148,2,False
-2,454,172,138,-34,False
-2,247,154,156,2,False
-2,40,136,138,2,False
-2,339,162,148,-14,False
-2,132,144,146,2,False
-2,431,170,140,-30,False
-2,224,152,154,2,False
-2,17,134,136,2,False
-2,316,160,150,-10,False
-2,109,142,144,2,False
-2,408,168,142,-26,False
-2,201,150,152,2,False
-2,500,176,134,-42,False
-2,293,158,152,-6,False
-2,86,140,142,2,False
-2,385,166,144,-22,False
-2,178,148,150,2,False
-2,477,174,136,-38,False
-2,270,156,154,-2,False
-2,63,138,140,2,False
-2,362,164,146,-18,False
-2,155,146,148,2,False
-2,454,172,138,-34,False
-2,247,154,156,2,False
-2,40,136,138,2,False
-2,339,162,148,-14,False
-2,132,144,146,2,False
-2,431,170,140,-30,False
-2,224,152,154,2,False
-2,17,134,136,2,False
-2,316,160,150,-10,False
-2,109,142,144,2,False
-2,408,168,142,-26,False
-2,201,150,152,2,False
-2,500,176,134,-42,False
-2,293,158,152,-6,False
-2,86,140,142,2,False
-2,385,166,144,-22,False
-2,178,148,150,2,False
-2,477,174,136,-38,False
-2,270,156,154,-2,False
-2,63,138,140,2,False
-2,362,164,146,-18,False
-2,155,146,148,2,False
-2,454,172,138,-34,False
-2,247,154,156,2,False
-2,40,136,138,2,False
-2,339,162,148,-14,False
-2,132,144,146,2,False
-2,431,170,140,-30,False
-2,224,152,154,2,False
-2,17,134,136,2,False
-2,316,160,150,-10,False
-2,109,142,144,2,False
-2,408,168,142,-26,False
-2,201,150,152,2,False
-2,500,176,134,-42,False
-2,293,158,152,-6,False
-2,86,140,142,2,False
-2,385,166,144,-22,False
-2,178,148,150,2,False
-2,477,174,136,-38,False
-2,270,156,154,-2,False
-2,63,138,140,2,False
-2,362,164,146,-18,False
-2,155,146,148,2,False
-2,454,172,138,-34,False
-2,247,154,156,2,False
-2,40,136,138,2,False
-2,339,162,148,-14,False
-2,132,144,146,2,False
-2,431,170,140,-30,False
-2,224,152,154,2,False
-2,17,134,136,2,False
-2,316,160,150,-10,False
-2,109,142,144,2,False
-2,408,168,142,-26,False
-2,201,150,152,2,False
-2,500,176,134,-42,False
-2,293,158,152,-6,False
-2,86,140,142,2,False
-2,385,166,144,-22,False
-2,178,148,150,2,False
-2,477,174,136,-38,False
-2,270,156,154,-2,False
-2,63,138,140,2,False
-2,362,164,146,-18,False
-2,155,146,148,2,False
-2,454,172,138,-34,False
-2,247,154,156,2,False
-2,40,136,138,2,False
-2,339,162,148,-14,False
-2,132,144,146,2,False
-2,431,170,140,-30,False
-2,224,152,154,2,False
-2,17,134,136,2,False
-2,316,160,150,-10,False
-2,109,142,144,2,False
-2,408,168,142,-26,False
-2,201,150,152,2,False
-2,500,176,134,-42,False
-2,293,158,152,-6,False
-2,86,140,142,2,False
-2,385,166,144,-22,False
-2,178,148,150,2,False
-2,477,174,136,-38,False
-2,270,156,154,-2,False
-2,63,138,140,2,False
-2,362,164,146,-18,False
-2,155,146,148,2,False
-2,454,172,138,-34,False
-2,247,154,156,2,False
-2,40,136,138,2,False
-2,339,162,148,-14,False
-2,132,144,146,2,False
-2,431,170,140,-30,False
-2,224,152,154,2,False
-2,17,134,136,2,False
-2,316,160,150,-10,False
-2,109,142,144,2,False
-2,408,168,142,-26,False
-2,201,150,152,2,False
-2,500,176,134,-42,False
-2,293,158,152,-6,False
-2,86,140,142,2,False
-2,385,166,144,-22,False
-2,178,148,150,2,False
-2,477,174,136,-38,False
-2,270,156,154,-2,False
-2,63,138,140,2,False
-2,362,164,146,-18,False
-2,155,146,148,2,False
-2,454,172,138,-34,False
-2,247,154,156,2,False
-2,40,136,138,2,False
-2,339,162,148,-14,False
-2,132,144,146,2,False
-2,431,170,140,-30,False
-2,224,152,154,2,False
-2,17,134,136,2,False
-2,316,160,150,-10,False
-2,109,142,144,2,False
-2,408,168,142,-26,False
-2,201,150,152,2,False
-2,500,176,134,-42,False
-2,293,158,152,-6,False
-2,86,140,142,2,False
-2,385,166,144,-22,False
-2,178,148,150,2,False
-2,477,174,136,-38,False
-2,270,156,154,-2,False
-2,63,138,140,2,False
-2,362,164,146,-18,False
-2,155,146,148,2,False
-2,454,172,138,-34,False
-2,247,154,156,2,False
-2,40,136,138,2,False
-2,339,162,148,-14,False
-2,132,144,146,2,False
-2,431,170,140,-30,False
-2,224,152,154,2,False
-2,17,134,136,2,False
-2,316,160,150,-10,False
-2,109,142,144,2,False
-2,408,168,142,-26,False
-2,201,150,152,2,False
-2,500,176,134,-42,False
-2,293,158,152,-6,False
-2,86,140,142,2,False
-2,385,166,144,-22,False
-2,178,148,150,2,False
-2,477,174,136,-38,False
-2,270,156,154,-2,False
-2,63,138,140,2,False
-2,362,164,146,-18,False
-2,155,146,148,2,False
-2,454,172,138,-34,False
-2,247,154,156,2,False
-2,40,136,138,2,False
-2,339,162,148,-14,False
-2,132,144,146,2,False
-2,431,170,140,-30,False
-2,224,152,154,2,False
-2,17,134,136,2,False
-2,316,160,150,-10,False
-2,109,142,144,2,False
-2,408,168,142,-26,False
-2,201,150,152,2,False
-2,500,176,134,-42,False
-2,293,158,152,-6,False
-2,86,140,142,2,False
-2,385,166,144,-22,False
-2,178,148,150,2,False
-2,477,174,136,-38,False
-2,270,156,154,-2,False
-2,63,138,140,2,False
-2,362,164,146,-18,False
-2,155,146,148,2,False
-2,454,172,138,-34,False
-2,247,154,156,2,False
-2,40,136,138,2,False
-2,339,162,148,-14,False
-2,132,144,146,2,False
-2,431,170,140,-30,False
-2,224,152,154,2,False
-2,17,134,136,2,False
-2,316,160,150,-10,False
-2,109,142,144,2,False
-2,408,168,142,-26,False
-2,201,150,152,2,False
-2,500,176,134,-42,False
-2,293,158,152,-6,False
-2,86,140,142,2,False
-2,385,166,144,-22,False
-2,178,148,150,2,False
-2,477,174,136,-38,False
-2,270,156,154,-2,False
-2,63,138,140,2,False
-2,362,164,146,-18,False
-2,155,146,148,2,False
-2,454,172,138,-34,False
-2,247,154,156,2,False
-2,40,136,138,2,False
-2,339,162,148,-14,False
-2,132,144,146,2,False
-2,431,170,140,-30,False
-2,224,152,154,2,False
-2,17,134,136,2,False
-2,316,160,150,-10,False
-2,109,142,144,2,False
-2,408,168,142,-26,False
-2,201,150,152,2,False
-2,500,176,134,-42,False
-2,293,158,152,-6,False
-2,86,140,142,2,False
-2,385,166,144,-22,False
-2,178,148,150,2,False
-2,477,174,136,-38,False
-2,270,156,154,-2,False
-2,63,138,140,2,False
-2,362,164,146,-18,False
-2,155,146,148,2,False
-2,454,172,138,-34,False
-2,247,154,156,2,False
-2,40,136,138,2,False
-2,339,162,148,-14,False
-2,132,144,146,2,False
-2,431,170,140,-30,False
-2,224,152,154,2,False
-2,17,134,136,2,False
-2,316,160,150,-10,False
-2,109,142,144,2,False
-2,408,168,142,-26,False
-2,201,150,152,2,False
-2,500,176,134,-42,False
-2,293,158,152,-6,False
-2,86,140,142,2,False
-2,385,166,144,-22,False
-2,178,148,150,2,False
-2,477,174,136,-38,False
-2,270,156,154,-2,False
-2,63,138,140,2,False
-2,362,164,146,-18,False
-2,155,146,148,2,False
-2,454,172,138,-34,False
-2,247,154,156,2,False
-2,40,136,138,2,False
-2,339,162,148,-14,False
-2,132,144,146,2,False
-2,431,170,140,-30,False
-2,224,152,154,2,False
-2,17,134,136,2,False
-2,316,160,150,-10,False
-2,109,142,144,2,False
-2,408,168,142,-26,False
-2,201,150,152,2,False
-2,500,176,134,-42,False
-2,293,158,152,-6,False
-2,86,140,142,2,False
-2,385,166,144,-22,False
-2,178,148,150,2,False
-2,477,174,136,-38,False
-2,270,156,154,-2,False
-2,63,138,140,2,False
-2,362,164,146,-18,False
-2,155,146,148,2,False
-2,454,172,138,-34,False
-2,247,154,156,2,False
-2,40,136,138,2,False
-2,339,162,148,-14,False
-2,132,144,146,2,False
-2,431,170,140,-30,False
-2,224,152,154,2,False
-2,17,134,136,2,False
-2,316,160,150,-10,False
-2,109,142,144,2,False
-2,408,168,142,-26,False
-2,201,150,152,2,False
-2,500,176,134,-42,False
-2,293,158,152,-6,False
-2,86,140,142,2,False
-2,385,166,144,-22,False
-2,178,148,150,2,False
-2,477,174,136,-38,False
-2,270,156,154,-2,False
-2,63,138,140,2,False
-2,362,164,146,-18,False
-2,155,146,148,2,False
-2,454,172,138,-34,False
-2,247,154,156,2,False
-2,40,136,138,2,False
-2,339,162,148,-14,False
-2,132,144,146,2,False
-2,431,170,140,-30,False
-2,224,152,154,2,False
-2,17,134,136,2,False
-2,316,160,150,-10,False
-2,109,142,144,2,False
-2,408,168,142,-26,False
-2,201,150,152,2,False
-2,500,176,134,-42,False
-2,293,158,152,-6,False
-2,86,140,142,2,False
-2,385,166,144,-22,False
-2,178,148,150,2,False
-2,477,174,136,-38,False
-2,270,156,154,-2,False
-2,63,138,140,2,False
-2,362,164,146,-18,False
-2,155,146,148,2,False
-2,454,172,138,-34,False
-2,247,154,156,2,False
-2,40,136,138,2,False
-2,339,162,148,-14,False
-2,132,144,146,2,False
-2,431,170,140,-30,False
-2,224,152,154,2,False
-2,17,134,136,2,False
-2,316,160,150,-10,False
-2,109,142,144,2,False
-2,408,168,142,-26,False
-2,201,150,152,2,False
-2,500,176,134,-42,False
-2,293,158,152,-6,False
-2,86,140,142,2,False
-2,385,166,144,-22,False
-2,178,148,150,2,False
-2,477,174,136,-38,False
-2,270,156,154,-2,False
-2,63,138,140,2,False
-2,362,164,146,-18,False
-2,155,146,148,2,False
-2,454,172,138,-34,False
-2,247,154,156,2,False
-2,40,136,138,2,False
-2,339,162,148,-14,False
-2,132,144,146,2,False
-2,431,170,140,-30,False
-2,224,152,154,2,False
-2,17,134,136,2,False
-2,316,160,150,-10,False
-2,109,142,144,2,False
-2,408,168,142,-26,False
-2,201,150,152,2,False
-2,500,176,134,-42,False
-2,293,158,152,-6,False
-2,86,140,142,2,False
-2,385,166,144,-22,False
-2,178,148,150,2,False
-2,477,174,136,-38,False
-2,270,156,154,-2,False
-2,63,138,140,2,False
-2,362,164,146,-18,False
-2,155,146,148,2,False
-2,454,172,138,-34,False
-2,247,154,156,2,False
-2,40,136,138,2,False
-2,339,162,148,-14,False
-2,132,144,146,2,False
-2,431,170,140,-30,False
-2,224,152,154,2,False
-2,17,134,136,2,False
-2,316,160,150,-10,False
-2,109,142,144,2,False
-2,408,168,142,-26,False
-2,201,150,152,2,False
-2,500,176,134,-42,False
-2,293,158,152,-6,False
-2,86,140,142,2,False
-2,385,166,144,-22,False
-2,178,148,150,2,False
-2,477,174,136,-38,False
-2,270,156,154,-2,False
-2,63,138,140,2,False
-2,362,164,146,-18,False
-2,155,146,148,2,False
-2,454,172,138,-34,False
-2,247,154,156,2,False
-2,40,136,138,2,False
-2,339,162,148,-14,False
-2,132,144,146,2,False
-2,431,170,140,-30,False
-2,224,152,154,2,False
-2,17,134,136,2,False
-2,316,160,150,-10,False
-2,109,142,144,2,False
-2,408,168,142,-26,False
-2,201,150,152,2,False
-2,500,176,134,-42,False
-2,293,158,152,-6,False
-2,86,140,142,2,False
-2,385,166,144,-22,False
-2,178,148,150,2,False
-2,477,174,136,-38,False
-2,270,156,154,-2,False
-2,63,138,140,2,False
-2,362,164,146,-18,False
-2,155,146,148,2,False
-2,454,172,138,-34,False
-2,247,154,156,2,False
-2,40,136,138,2,False
-2,339,162,148,-14,False
-2,132,144,146,2,False
-2,431,170,140,-30,False
-2,224,152,154,2,False
-2,17,134,136,2,False
-2,316,160,150,-10,False
-2,109,142,144,2,False
-2,408,168,142,-26,False
-2,201,150,152,2,False
-2,500,176,134,-42,False
-2,293,158,152,-6,False
-2,86,140,142,2,False
-2,385,166,144,-22,False
-2,178,148,150,2,False
-2,477,174,136,-38,False
-2,270,156,154,-2,False
-2,63,138,140,2,False
-2,362,164,146,-18,False
-2,155,146,148,2,False
-2,454,172,138,-34,False
-2,247,154,156,2,False
-2,40,136,138,2,False
-2,339,162,148,-14,False
-2,132,144,146,2,False
-2,431,170,140,-30,False
-2,224,152,154,2,False
-2,17,134,136,2,False
-2,316,160,150,-10,False
-2,109,142,144,2,False
-2,408,168,142,-26,False
-2,201,150,152,2,False
-2,500,176,134,-42,False
-2,293,158,152,-6,False
-2,86,140,142,2,False
-2,385,166,144,-22,False
-2,178,148,150,2,False
-2,477,174,136,-38,False
-2,270,156,154,-2,False
-2,63,138,140,2,False
-2,362,164,146,-18,False
-2,155,146,148,2,False
-2,454,172,138,-34,False
-2,247,154,156,2,False
-2,40,136,138,2,False
-2,339,162,148,-14,False
-2,132,144,146,2,False
-2,431,170,140,-30,False
-2,224,152,154,2,False
-2,17,134,136,2,False
-2,316,160,150,-10,False
-2,109,142,144,2,False
-2,408,168,142,-26,False
-2,201,150,152,2,False
-2,500,176,134,-42,False
-2,293,158,152,-6,False
-2,86,140,142,2,False
-2,385,166,144,-22,False
-2,178,148,150,2,False
-2,477,174,136,-38,False
-2,270,156,154,-2,False
-2,63,138,140,2,False
-2,362,164,146,-18,False
-2,155,146,148,2,False
-2,454,172,138,-34,False
-2,247,154,156,2,False
-2,40,136,138,2,False
-2,339,162,148,-14,False
-2,132,144,146,2,False
-2,431,170,140,-30,False
-2,224,152,154,2,False
-2,17,134,136,2,False
-2,316,160,150,-10,False
-2,109,142,144,2,False
-2,408,168,142,-26,False
-2,201,150,152,2,False
-2,500,176,134,-42,False
-2,293,158,152,-6,False
-2,86,140,142,2,False
-2,385,166,144,-22,False
-2,178,148,150,2,False
-2,477,174,136,-38,False
-2,270,156,154,-2,False
-2,63,138,140,2,False
-2,362,164,146,-18,False
-2,155,146,148,2,False
-2,454,172,138,-34,False
-2,247,154,156,2,False
-2,40,136,138,2,False
-2,339,162,148,-14,False
-2,132,144,146,2,False
-2,431,170,140,-30,False
-2,224,152,154,2,False
-2,17,134,136,2,False
-2,316,160,150,-10,False
-2,109,142,144,2,False
-2,408,168,142,-26,False
-2,201,150,152,2,False
-2,500,176,134,-42,False
-2,293,158,152,-6,False
-2,86,140,142,2,False
-2,385,166,144,-22,False
-2,178,148,150,2,False
-2,477,174,136,-38,False
-2,270,156,154,-2,False
-2,63,138,140,2,False
-2,362,164,146,-18,False
-2,155,146,148,2,False
-2,454,172,138,-34,False
-2,247,154,156,2,False
-2,40,136,138,2,False
-2,339,162,148,-14,False
-2,132,144,146,2,False
-2,431,170,140,-30,False
-2,224,152,154,2,False
-2,17,134,136,2,False
-2,316,160,150,-10,False
-2,109,142,144,2,False
-2,408,168,142,-26,False
-2,201,150,152,2,False
-2,500,176,134,-42,False
-2,293,158,152,-6,False
-2,86,140,142,2,False
-2,385,166,144,-22,False
-2,178,148,150,2,False
-2,477,174,136,-38,False
-2,270,156,154,-2,False
-2,63,138,140,2,False
-2,362,164,146,-18,False
-2,155,146,148,2,False
-2,454,172,138,-34,False
-2,247,154,156,2,False
-2,40,136,138,2,False
-2,339,162,148,-14,False
-2,132,144,146,2,False
-2,431,170,140,-30,False
-2,224,152,154,2,False
-2,17,134,136,2,False
-2,316,160,150,-10,False
-2,109,142,144,2,False
-2,408,168,142,-26,False
-2,201,150,152,2,False
-2,500,176,134,-42,False
-2,293,158,152,-6,False
-2,86,140,142,2,False
-2,385,166,144,-22,False
-2,178,148,150,2,False
-2,477,174,136,-38,False
-2,270,156,154,-2,False
-2,63,138,140,2,False
-2,362,164,146,-18,False
-2,155,146,148,2,False
-2,454,172,138,-34,False
-2,247,154,156,2,False
-2,40,136,138,2,False
-2,339,162,148,-14,False
-2,132,144,146,2,False
-2,431,170,140,-30,False
-2,224,152,154,2,False
-2,17,134,136,2,False
-2,316,160,150,-10,False
-2,109,142,144,2,False
-2,408,168,142,-26,False
-2,201,150,152,2,False
-2,500,176,134,-42,False
-2,293,158,152,-6,False
-2,86,140,142,2,False
-2,385,166,144,-22,False
-2,178,148,150,2,False
-2,477,174,136,-38,False
-2,270,156,154,-2,False
-2,63,138,140,2,False
-2,362,164,146,-18,False
-2,155,146,148,2,False
-2,454,172,138,-34,False
-2,247,154,156,2,False
-2,40,136,138,2,False
-2,339,162,148,-14,False
-2,132,144,146,2,False
-2,431,170,140,-30,False
-2,224,152,154,2,False
-2,17,134,136,2,False
-2,316,160,150,-10,False
-2,109,142,144,2,False
-2,408,168,142,-26,False
-2,201,150,152,2,False
-2,500,176,134,-42,False
-2,293,158,152,-6,False
-2,86,140,142,2,False
-2,385,166,144,-22,False
-2,178,148,150,2,False
-2,477,174,136,-38,False
-2,270,156,154,-2,False
-2,63,138,140,2,False
-2,362,164,146,-18,False
-2,155,146,148,2,False
-2,454,172,138,-34,False
-2,247,154,156,2,False
-2,40,136,138,2,False
-2,339,162,148,-14,False
-2,132,144,146,2,False
-2,431,170,140,-30,False
-2,224,152,154,2,False
-2,17,134,136,2,False
-2,316,160,150,-10,False
-2,109,142,144,2,False
-2,408,168,142,-26,False
-2,201,150,152,2,False
-2,500,176,134,-42,False
-2,293,158,152,-6,False
-2,86,140,142,2,False
-2,385,166,144,-22,False
-2,178,148,150,2,False
-2,477,174,136,-38,False
-2,270,156,154,-2,False
-2,63,138,140,2,False
-2,362,164,146,-18,False
-2,155,146,148,2,False
-2,454,172,138,-34,False
-2,247,154,156,2,False
-2,40,136,138,2,False
-2,339,162,148,-14,False
-2,132,144,146,2,False
-2,431,170,140,-30,False
-2,224,152,154,2,False
-2,17,134,136,2,False
-2,316,160,150,-10,False
-2,109,142,144,2,False
-2,408,168,142,-26,False
-2,201,150,152,2,False
-2,500,176,134,-42,False
-2,293,158,152,-6,False
-2,86,140,142,2,False
-2,385,166,144,-22,False
-2,178,148,150,2,False
-2,477,174,136,-38,False
-2,270,156,154,-2,False
-2,63,138,140,2,False
-2,362,164,146,-18,False
-2,155,146,148,2,False
-2,454,172,138,-34,False
-2,247,154,156,2,False
-2,40,136,138,2,False
-2,339,162,148,-14,False
-2,132,144,146,2,False
-2,431,170,140,-30,False
-2,224,152,154,2,False
-2,17,134,136,2,False
-2,316,160,150,-10,False
-2,109,142,144,2,False
-2,408,168,142,-26,False
-2,201,150,152,2,False
-2,500,176,134,-42,False
-2,293,158,152,-6,False
-2,86,140,142,2,False
-2,385,166,144,-22,False
-2,178,148,150,2,False
-2,477,174,136,-38,False
-2,270,156,154,-2,False
-2,63,138,140,2,False
-2,362,164,146,-18,False
-2,155,146,148,2,False
-2,454,172,138,-34,False
-2,247,154,156,2,False
-2,40,136,138,2,False
-2,339,162,148,-14,False
-2,132,144,146,2,False
-2,431,170,140,-30,False
-2,224,152,154,2,False
-2,17,134,136,2,False
-2,316,160,150,-10,False
-2,109,142,144,2,False
-2,408,168,142,-26,False
-2,201,150,152,2,False
-2,500,176,134,-42,False
-2,293,158,152,-6,False
-2,86,140,142,2,False
-2,385,166,144,-22,False
-2,178,148,150,2,False
-2,477,174,136,-38,False
-2,270,156,154,-2,False
-2,63,138,140,2,False
-2,362,164,146,-18,False
-2,155,146,148,2,False
-2,454,172,138,-34,False
-2,247,154,156,2,False
-2,40,136,138,2,False
-2,339,162,148,-14,False
-2,132,144,146,2,False
-2,431,170,140,-30,False
-2,224,152,154,2,False
-2,17,134,136,2,False
-2,316,160,150,-10,False
-2,109,142,144,2,False
-2,408,168,142,-26,False
-2,201,150,152,2,False
-2,500,176,134,-42,False
-2,293,158,152,-6,False
-2,86,140,142,2,False
-2,385,166,144,-22,False
-2,178,148,150,2,False
-2,477,174,136,-38,False
-2,270,156,154,-2,False
-2,63,138,140,2,False
-2,362,164,146,-18,False
-2,155,146,148,2,False
-2,454,172,138,-34,False
-2,247,154,156,2,False
-2,40,136,138,2,False
-2,339,162,148,-14,False
-2,132,144,146,2,False
-2,431,170,140,-30,False
-2,224,152,154,2,False
-2,17,134,136,2,False
-2,316,160,150,-10,False
-2,109,142,144,2,False
-2,408,168,142,-26,False
-2,201,150,152,2,False
-2,500,176,134,-42,False
-2,293,158,152,-6,False
-2,86,140,142,2,False
-2,385,166,144,-22,False
-2,178,148,150,2,False
-2,477,174,136,-38,False
-2,270,156,154,-2,False
-2,63,138,140,2,False
-2,362,164,146,-18,False
-2,155,146,148,2,False
-2,454,172,138,-34,False
-2,247,154,156,2,False
-2,40,136,138,2,False
-2,339,162,148,-14,False
-2,132,144,146,2,False
-2,431,170,140,-30,False
-2,224,152,154,2,False
-2,17,134,136,2,False
-2,316,160,150,-10,False
-2,109,142,144,2,False
-2,408,168,142,-26,False
-2,201,150,152,2,False
-2,500,176,134,-42,False
-2,293,158,152,-6,False
-2,86,140,142,2,False
-2,385,166,144,-22,False
-2,178,148,150,2,False
-2,477,174,136,-38,False
-2,270,156,154,-2,False
-2,63,138,140,2,False
-2,362,164,146,-18,False
-2,155,146,148,2,False
-2,454,172,138,-34,False
-2,247,154,156,2,False
-2,40,136,138,2,False
-2,339,162,148,-14,False
-2,132,144,146,2,False
-2,431,170,140,-30,False
-2,224,152,154,2,False
-2,17,134,136,2,False
-2,316,160,150,-10,False
-2,109,142,144,2,False
-2,408,168,142,-26,False
-2,201,150,152,2,False
-2,500,176,134,-42,False
-2,293,158,152,-6,False
-2,86,140,142,2,False
-2,385,166,144,-22,False
-2,178,148,150,2,False
-2,477,174,136,-38,False
-2,270,156,154,-2,False
-2,63,138,140,2,False
-2,362,164,146,-18,False
-2,155,146,148,2,False
-2,454,172,138,-34,False
-2,247,154,156,2,False
-2,40,136,138,2,False
-2,339,162,148,-14,False
-2,132,144,146,2,False
-2,431,170,140,-30,False
-2,224,152,154,2,False
-2,17,134,136,2,False
-2,316,160,150,-10,False
-2,109,142,144,2,False
-2,408,168,142,-26,False
-2,201,150,152,2,False
-2,500,176,134,-42,False
-2,293,158,152,-6,False
-2,86,140,142,2,False
-2,385,166,144,-22,False
-2,178,148,150,2,False
-2,477,174,136,-38,False
-2,270,156,154,-2,False
-2,63,138,140,2,False
-2,362,164,146,-18,False
-2,155,146,148,2,False
-2,454,172,138,-34,False
-2,247,154,156,2,False
-2,40,136,138,2,False
-2,339,162,148,-14,False
-2,132,144,146,2,False
-2,431,170,140,-30,False
-2,224,152,154,2,False
-2,17,134,136,2,False
-2,316,160,150,-10,False
-2,109,142,144,2,False
-2,408,168,142,-26,False
-2,201,150,152,2,False
-2,500,176,134,-42,False
-2,293,158,152,-6,False
-2,86,140,142,2,False
-2,385,166,144,-22,False
-2,178,148,150,2,False
-2,477,174,136,-38,False
-2,270,156,154,-2,False
-2,63,138,140,2,False
-2,362,164,146,-18,False
-2,155,146,148,2,False
-2,454,172,138,-34,False
-2,247,154,156,2,False
-2,40,136,138,2,False
-2,339,162,148,-14,False
-2,132,144,146,2,False
-2,431,170,140,-30,False
-2,224,152,154,2,False
-2,17,134,136,2,False
-2,316,160,150,-10,False
-2,109,142,144,2,False
-2,408,168,142,-26,False
-2,201,150,152,2,False
-2,500,176,134,-42,False
-2,293,158,152,-6,False
-2,86,140,142,2,False
-2,385,166,144,-22,False
-2,178,148,150,2,False
-2,477,174,136,-38,False
-2,270,156,154,-2,False
-2,63,138,140,2,False
-2,362,164,146,-18,False
-2,155,146,148,2,False
-2,454,172,138,-34,False
-2,247,154,156,2,False
-2,40,136,138,2,False
-2,339,162,148,-14,False
-2,132,144,146,2,False
-2,431,170,140,-30,False
-2,224,152,154,2,False
-2,17,134,136,2,False
-2,316,160,150,-10,False
-2,109,142,144,2,False
-2,408,168,142,-26,False
-2,201,150,152,2,False
-2,500,176,134,-42,False
-2,293,158,152,-6,False
-2,86,140,142,2,False
-2,385,166,144,-22,False
-2,178,148,150,2,False
-2,477,174,136,-38,False
-2,270,156,154,-2,False
-2,63,138,140,2,False
-2,362,164,146,-18,False
-2,155,146,148,2,False
-2,454,172,138,-34,False
-2,247,154,156,2,False
-2,40,136,138,2,False
-2,339,162,148,-14,False
-2,132,144,146,2,False
-2,431,170,140,-30,False
-2,224,152,154,2,False
-2,17,134,136,2,False
-2,316,160,150,-10,False
-2,109,142,144,2,False
-2,408,168,142,-26,False
-2,201,150,152,2,False
-2,500,176,134,-42,False
-2,293,158,152,-6,False
-2,86,140,142,2,False
-2,385,166,144,-22,False
-2,178,148,150,2,False
-2,477,174,136,-38,False
-2,270,156,154,-2,False
-2,63,138,140,2,False
-2,362,164,146,-18,False
-2,155,146,148,2,False
-2,454,172,138,-34,False
-2,247,154,156,2,False
-2,40,136,138,2,False
-2,339,162,148,-14,False
-2,132,144,146,2,False
-2,431,170,140,-30,False
-2,224,152,154,2,False
-2,17,134,136,2,False
-2,316,160,150,-10,False
-2,109,142,144,2,False
-2,408,168,142,-26,False
-2,201,150,152,2,False
-2,500,176,134,-42,False
-2,293,158,152,-6,False
-2,86,140,142,2,False
-2,385,166,144,-22,False
-2,178,148,150,2,False
-2,477,174,136,-38,False
-2,270,156,154,-2,False
-2,63,138,140,2,False
-2,362,164,146,-18,False
-2,155,146,148,2,False
-2,454,172,138,-34,False
-2,247,154,156,2,False
-2,40,136,138,2,False
-2,339,162,148,-14,False
-2,132,144,146,2,False
-2,431,170,140,-30,False
-2,224,152,154,2,False
-2,17,134,136,2,False
-2,316,160,150,-10,False
-2,109,142,144,2,False
-2,408,168,142,-26,False
-2,201,150,152,2,False
-2,500,176,134,-42,False
-2,293,158,152,-6,False
-2,86,140,142,2,False
-2,385,166,144,-22,False
-2,178,148,150,2,False
-2,477,174,136,-38,False
-2,270,156,154,-2,False
-2,63,138,140,2,False
-2,362,164,146,-18,False
-2,155,146,148,2,False
-2,454,172,138,-34,False
-2,247,154,156,2,False
-2,40,136,138,2,False
-2,339,162,148,-14,False
-2,132,144,146,2,False
-2,431,170,140,-30,False
-2,224,152,154,2,False
-2,17,134,136,2,False
-2,316,160,150,-10,False
-2,109,142,144,2,False
-2,408,168,142,-26,False
-2,201,150,152,2,False
-2,500,176,134,-42,False
-2,293,158,152,-6,False
-2,86,140,142,2,False
-2,385,166,144,-22,False
-2,178,148,150,2,False
-2,477,174,136,-38,False
-2,270,156,154,-2,False
-2,63,138,140,2,False
-2,362,164,146,-18,False
-2,155,146,148,2,False
-2,454,172,138,-34,False
-2,247,154,156,2,False
-2,40,136,138,2,False
-2,339,162,148,-14,False
-2,132,144,146,2,False
-2,431,170,140,-30,False
-2,224,152,154,2,False
-2,17,134,136,2,False
-2,316,160,150,-10,False
-2,109,142,144,2,False
-2,408,168,142,-26,False
-2,201,150,152,2,False
-2,500,176,134,-42,False
-2,293,158,152,-6,False
-2,86,140,142,2,False
-2,385,166,144,-22,False
-2,178,148,150,2,False
-2,477,174,136,-38,False
-2,270,156,154,-2,False
-2,63,138,140,2,False
-2,362,164,146,-18,False
-2,155,146,148,2,False
-2,454,172,138,-34,False
-2,247,154,156,2,False
-2,40,136,138,2,False
-2,339,162,148,-14,False
-2,132,144,146,2,False
-2,431,170,140,-30,False
-2,224,152,154,2,False
-2,17,134,136,2,False
-2,316,160,150,-10,False
-2,109,142,144,2,False
-2,408,168,142,-26,False
-2,201,150,152,2,False
-2,500,176,134,-42,False
-2,293,158,152,-6,False
-2,86,140,142,2,False
-2,385,166,144,-22,False
-2,178,148,150,2,False
-2,477,174,136,-38,False
-2,270,156,154,-2,False
-2,63,138,140,2,False
-2,362,164,146,-18,False
-2,155,146,148,2,False
-2,454,172,138,-34,False
-2,247,154,156,2,False
-2,40,136,138,2,False
-2,339,162,148,-14,False
-2,132,144,146,2,False
-2,431,170,140,-30,False
-2,224,152,154,2,False
-2,17,134,136,2,False
-2,316,160,150,-10,False
-2,109,142,144,2,False
-2,408,168,142,-26,False
-2,201,150,152,2,False
-2,500,176,134,-42,False
-2,293,158,152,-6,False
-2,86,140,142,2,False
-2,385,166,144,-22,False
-2,178,148,150,2,False
-2,477,174,136,-38,False
-2,270,156,154,-2,False
-2,63,138,140,2,False
-2,362,164,146,-18,False
-2,155,146,148,2,False
-2,454,172,138,-34,False
-2,247,154,156,2,False
-2,40,136,138,2,False
-2,339,162,148,-14,False
-2,132,144,146,2,False
-2,431,170,140,-30,False
-2,224,152,154,2,False
-2,17,134,136,2,False
-2,316,160,150,-10,False
-2,109,142,144,2,False
-2,408,168,142,-26,False
-2,201,150,152,2,False
-2,500,176,134,-42,False
-2,293,158,152,-6,False
-2,86,140,142,2,False
-2,385,166,144,-22,False
-2,178,148,150,2,False
-2,477,174,136,-38,False
-2,270,156,154,-2,False
-2,63,138,140,2,False
-2,362,164,146,-18,False
-2,155,146,148,2,False
-2,454,172,138,-34,False
-2,247,154,156,2,False
-2,40,136,138,2,False
-2,339,162,148,-14,False
-2,132,144,146,2,False
-2,431,170,140,-30,False
-2,224,152,154,2,False
-2,17,134,136,2,False
-2,316,160,150,-10,False
-2,109,142,144,2,False
-2,408,168,142,-26,False
-2,201,150,152,2,False
-2,500,176,134,-42,False
-2,293,158,152,-6,False
-2,86,140,142,2,False
-2,385,166,144,-22,False
-2,178,148,150,2,False
-2,477,174,136,-38,False
-2,270,156,154,-2,False
-2,63,138,140,2,False
-2,362,164,146,-18,False
-2,155,146,148,2,False
-2,454,172,138,-34,False
-2,247,154,156,2,False
-2,40,136,138,2,False
-2,339,162,148,-14,False
-2,132,144,146,2,False
-2,431,170,140,-30,False
-2,224,152,154,2,False
-2,17,134,136,2,False
-2,316,160,150,-10,False
-2,109,142,144,2,False
-2,408,168,142,-26,False
-2,201,150,152,2,False
-2,500,176,134,-42,False
-2,293,158,152,-6,False
-2,86,140,142,2,False
-2,385,166,144,-22,False
-2,178,148,150,2,False
-2,477,174,136,-38,False
-2,270,156,154,-2,False
-2,63,138,140,2,False
-2,362,164,146,-18,False
-2,155,146,148,2,False
-2,454,172,138,-34,False
-2,247,154,156,2,False
-2,40,136,138,2,False
-2,339,162,148,-14,False
-2,132,144,146,2,False
-2,431,170,140,-30,False
-2,224,152,154,2,False
-2,17,134,136,2,False
-2,316,160,150,-10,False
-2,109,142,144,2,False
-2,408,168,142,-26,False
-2,201,150,152,2,False
-2,500,176,134,-42,False
-2,293,158,152,-6,False
-2,86,140,142,2,False
-2,385,166,144,-22,False
-2,178,148,150,2,False
-2,477,174,136,-38,False
-2,270,156,154,-2,False
-2,63,138,140,2,False
-2,362,164,146,-18,False
-2,155,146,148,2,False
-2,454,172,138,-34,False
-2,247,154,156,2,False
-2,40,136,138,2,False
-2,339,162,148,-14,False
-2,132,144,146,2,False
-2,431,170,140,-30,False
-2,224,152,154,2,False
-2,17,134,136,2,False
-2,316,160,150,-10,False
-2,109,142,144,2,False
-2,408,168,142,-26,False
-2,201,150,152,2,False
-2,500,176,134,-42,False
-2,293,158,152,-6,False
-2,86,140,142,2,False
-2,385,166,144,-22,False
-2,178,148,150,2,False
-2,477,174,136,-38,False
-2,270,156,154,-2,False
-2,63,138,140,2,False
-2,362,164,146,-18,False
-2,155,146,148,2,False
-2,454,172,138,-34,False
-2,247,154,156,2,False
-2,40,136,138,2,False
-2,339,162,148,-14,False
-2,132,144,146,2,False
-2,431,170,140,-30,False
-2,224,152,154,2,False
-2,17,134,136,2,False
-2,316,160,150,-10,False
-2,109,142,144,2,False
-2,408,168,142,-26,False
-2,201,150,152,2,False
-2,500,176,134,-42,False
-2,293,158,152,-6,False
-2,86,140,142,2,False
-2,385,166,144,-22,False
-2,178,148,150,2,False
-2,477,174,136,-38,False
-2,270,156,154,-2,False
-2,63,138,140,2,False
-2,362,164,146,-18,False
-2,155,146,148,2,False
-2,454,172,138,-34,False
-2,247,154,156,2,False
-2,40,136,138,2,False
-2,339,162,148,-14,False
-2,132,144,146,2,False
-2,431,170,140,-30,False
-2,224,152,154,2,False
-2,17,134,136,2,False
-2,316,160,150,-10,False
-2,109,142,144,2,False
-2,408,168,142,-26,False
-2,201,150,152,2,False
-2,500,176,134,-42,False
-2,293,158,152,-6,False
-2,86,140,142,2,False
-2,385,166,144,-22,False
-2,178,148,150,2,False
-2,477,174,136,-38,False
-2,270,156,154,-2,False
-2,63,138,140,2,False
-2,362,164,146,-18,False
-2,155,146,148,2,False
-2,454,172,138,-34,False
-2,247,154,156,2,False
-2,40,136,138,2,False
-2,339,162,148,-14,False
-2,132,144,146,2,False
-2,431,170,140,-30,False
-2,224,152,154,2,False
-2,17,134,136,2,False
-2,316,160,150,-10,False
-2,109,142,144,2,False
-2,408,168,142,-26,False
-2,201,150,152,2,False
-2,500,176,134,-42,False
-2,293,158,152,-6,False
-2,86,140,142,2,False
-2,385,166,144,-22,False
-2,178,148,150,2,False
-2,477,174,136,-38,False
-2,270,156,154,-2,False
-2,63,138,140,2,False
-2,362,164,146,-18,False
-2,155,146,148,2,False
-2,454,172,138,-34,False
-2,247,154,156,2,False
-2,40,136,138,2,False
-2,339,162,148,-14,False
-2,132,144,146,2,False
-2,431,170,140,-30,False
-2,224,152,154,2,False
-2,17,134,136,2,False
-2,316,160,150,-10,False
-2,109,142,144,2,False
-2,408,168,142,-26,False
-2,201,150,152,2,False
-2,500,176,134,-42,False
-2,293,158,152,-6,False
-2,86,140,142,2,False
-2,385,166,144,-22,False
-2,178,148,150,2,False
-2,477,174,136,-38,False
-2,270,156,154,-2,False
-2,63,138,140,2,False
-2,362,164,146,-18,False
-2,155,146,148,2,False
-2,454,172,138,-34,False
-2,247,154,156,2,False
-2,40,136,138,2,False
-2,339,162,148,-14,False
-2,132,144,146,2,False
-2,431,170,140,-30,False
-2,224,152,154,2,False
-2,17,134,136,2,False
-2,316,160,150,-10,False
-2,109,142,144,2,False
-2,408,168,142,-26,False
-2,201,150,152,2,False
-2,500,176,134,-42,False
-2,293,158,152,-6,False
-2,86,140,142,2,False
-2,385,166,144,-22,False
-2,178,148,150,2,False
-2,477,174,136,-38,False
-2,270,156,154,-2,False
-2,63,138,140,2,False
-2,362,164,146,-18,False
-2,155,146,148,2,False
-2,454,172,138,-34,False
-2,247,154,156,2,False
-2,40,136,138,2,False
-2,339,162,148,-14,False
-2,132,144,146,2,False
-2,431,170,140,-30,False
-2,224,152,154,2,False
-2,17,134,136,2,False
-2,316,160,150,-10,False
-2,109,142,144,2,False
-2,408,168,142,-26,False
-2,201,150,152,2,False
-2,500,176,134,-42,False
-2,293,158,152,-6,False
-2,86,140,142,2,False
-2,385,166,144,-22,False
-2,178,148,150,2,False
-2,477,174,136,-38,False
-2,270,156,154,-2,False
-2,63,138,140,2,False
-2,362,164,146,-18,False
-2,155,146,148,2,False
-2,454,172,138,-34,False
-2,247,154,156,2,False
-2,40,136,138,2,False
-2,339,162,148,-14,False
-2,132,144,146,2,False
-2,431,170,140,-30,False
-2,224,152,154,2,False
-2,17,134,136,2,False
-2,316,160,150,-10,False
-2,109,142,144,2,False
-2,408,168,142,-26,False
-2,201,150,152,2,False
-2,500,176,134,-42,False
-2,293,158,152,-6,False
-2,86,140,142,2,False
-2,385,166,144,-22,False
-2,178,148,150,2,False
-2,477,174,136,-38,False
-2,270,156,154,-2,False
-2,63,138,140,2,False
-2,362,164,146,-18,False
-2,155,146,148,2,False
-2,454,172,138,-34,False
-2,247,154,156,2,False
-2,40,136,138,2,False
-2,339,162,148,-14,False
-2,132,144,146,2,False
-2,431,170,140,-30,False
-2,224,152,154,2,False
-2,17,134,136,2,False
-2,316,160,150,-10,False
-2,109,142,144,2,False
-2,408,168,142,-26,False
-2,201,150,152,2,False
-2,500,176,134,-42,False
-2,293,158,152,-6,False
-2,86,140,142,2,False
-2,385,166,144,-22,False
-2,178,148,150,2,False
-2,477,174,136,-38,False
-2,270,156,154,-2,False
-2,63,138,140,2,False
-2,362,164,146,-18,False
-2,155,146,148,2,False
-2,454,172,138,-34,False
-2,247,154,156,2,False
-2,40,136,138,2,False
-2,339,162,148,-14,False
-2,132,144,146,2,False
-2,431,170,140,-30,False
-2,224,152,154,2,False
-2,17,134,136,2,False
-2,316,160,150,-10,False
-2,109,142,144,2,False
-2,408,168,142,-26,False
-2,201,150,152,2,False
-2,500,176,134,-42,False
-2,293,158,152,-6,False
-2,86,140,142,2,False
-2,385,166,144,-22,False
-2,178,148,150,2,False
-2,477,174,136,-38,False
-2,270,156,154,-2,False
-2,63,138,140,2,False
-2,362,164,146,-18,False
-2,155,146,148,2,False
-2,454,172,138,-34,False
-2,247,154,156,2,False
-2,40,136,138,2,False
-2,339,162,148,-14,False
-2,132,144,146,2,False
-2,431,170,140,-30,False
-2,224,152,154,2,False
-2,17,134,136,2,False
-2,316,160,150,-10,False
-2,109,142,144,2,False
-2,408,168,142,-26,False
-2,201,150,152,2,False
-2,500,176,134,-42,False
-2,293,158,152,-6,False
-2,86,140,142,2,False
-2,385,166,144,-22,False
-2,178,148,150,2,False
-2,477,174,136,-38,False
-2,270,156,154,-2,False
-2,63,138,140,2,False
-2,362,164,146,-18,False
-2,155,146,148,2,False
-2,454,172,138,-34,False
-2,247,154,156,2,False
-2,40,136,138,2,False
-2,339,162,148,-14,False
-2,132,144,146,2,False
-2,431,170,140,-30,False
-2,224,152,154,2,False
-2,17,134,136,2,False
-2,316,160,150,-10,False
-2,109,142,144,2,False
-2,408,168,142,-26,False
-2,201,150,152,2,False
-2,500,176,134,-42,False
-2,293,158,152,-6,False
-2,86,140,142,2,False
-2,385,166,144,-22,False
-2,178,148,150,2,False
-2,477,174,136,-38,False
-2,270,156,154,-2,False
-2,63,138,140,2,False
-2,362,164,146,-18,False
-2,155,146,148,2,False
-2,454,172,138,-34,False
-2,247,154,156,2,False
-2,40,136,138,2,False
-2,339,162,148,-14,False
-2,132,144,146,2,False
-2,431,170,140,-30,False
-2,224,152,154,2,False
-2,17,134,136,2,False
-2,316,160,150,-10,False
-2,109,142,144,2,False
-2,408,168,142,-26,False
-2,201,150,152,2,False
-2,500,176,134,-42,False
-2,293,158,152,-6,False
-2,86,140,142,2,False
-2,385,166,144,-22,False
-2,178,148,150,2,False
-2,477,174,136,-38,False
-2,270,156,154,-2,False
-2,63,138,140,2,False
-2,362,164,146,-18,False
-2,155,146,148,2,False
-2,454,172,138,-34,False
-2,247,154,156,2,False
-2,40,136,138,2,False
-2,339,162,148,-14,False
-2,132,144,146,2,False
-2,431,170,140,-30,False
-2,224,152,154,2,False
-2,17,134,136,2,False
-2,316,160,150,-10,False
-2,109,142,144,2,False
-2,408,168,142,-26,False
-2,201,150,152,2,False
-2,500,176,134,-42,False
-2,293,158,152,-6,False
-2,86,140,142,2,False
-2,385,166,144,-22,False
-2,178,148,150,2,False
-2,477,174,136,-38,False
-2,270,156,154,-2,False
-2,63,138,140,2,False
-2,362,164,146,-18,False
-2,155,146,148,2,False
-2,454,172,138,-34,False
-2,247,154,156,2,False
-2,40,136,138,2,False
-2,339,162,148,-14,False
-2,132,144,146,2,False
-2,431,170,140,-30,False
-2,224,152,154,2,False
-2,17,134,136,2,False
-2,316,160,150,-10,False
-2,109,142,144,2,False
-2,408,168,142,-26,False
-2,201,150,152,2,False
-2,500,176,134,-42,False
-2,293,158,152,-6,False
-2,86,140,142,2,False
-2,385,166,144,-22,False
-2,178,148,150,2,False
-2,477,174,136,-38,False
-2,270,156,154,-2,False
-2,63,138,140,2,False
-2,362,164,146,-18,False
-2,155,146,148,2,False
-2,454,172,138,-34,False
-2,247,154,156,2,False
-2,40,136,138,2,False
-2,339,162,148,-14,False
-2,132,144,146,2,False
-2,431,170,140,-30,False
-2,224,152,154,2,False
-2,17,134,136,2,False
-2,316,160,150,-10,False
-2,109,142,144,2,False
-2,408,168,142,-26,False
-2,201,150,152,2,False
-2,500,176,134,-42,False
-2,293,158,152,-6,False
